state,county_name,county_fips,trump_votes,biden_votes,total_votes,percent_biden,winner
ALABAMA,AUTAUGA,1001,19838,7503,27341,27.442302768735598,Trump
ALABAMA,BALDWIN,1003,83544,24578,108122,22.731728972826993,Trump
ALABAMA,BARBOUR,1005,5622,4816,10438,46.139107108641504,Trump
ALABAMA,BIBB,1007,7525,1986,9511,20.8810850594049,Trump
ALABAMA,BLOUNT,1009,24711,2640,27351,9.652297905012613,Trump
ALABAMA,BULLOCK,1011,1146,3446,4592,75.04355400696863,Biden
ALABAMA,BUTLER,1013,5458,3965,9423,42.0778945134246,Trump
ALABAMA,CALHOUN,1015,35101,15216,50317,30.240276646063958,Trump
ALABAMA,CHAMBERS,1017,8753,6365,15118,42.10212991136394,Trump
ALABAMA,CHEROKEE,1019,10583,1624,12207,13.303842057835668,Trump
ALABAMA,CHILTON,1021,16085,3073,19158,16.040296481887463,Trump
ALABAMA,CHOCTAW,1023,4296,3127,7423,42.12582513808433,Trump
ALABAMA,CLARKE,1025,7324,5755,13079,44.001835002676046,Trump
ALABAMA,CLAY,1027,5601,1267,6868,18.447874199184625,Trump
ALABAMA,CLEBURNE,1029,6484,675,7159,9.428691157982959,Trump
ALABAMA,COFFEE,1031,16899,5076,21975,23.098976109215016,Trump
ALABAMA,COLBERT,1033,19203,8343,27546,30.287519059028533,Trump
ALABAMA,CONECUH,1035,3442,2966,6408,46.285892634207244,Trump
ALABAMA,COOSA,1037,3631,1796,5427,33.09379030772065,Trump
ALABAMA,COVINGTON,1039,14586,2721,17307,15.721962211821804,Trump
ALABAMA,CRENSHAW,1041,4864,1700,6564,25.898842169408898,Trump
ALABAMA,CULLMAN,1043,36880,4478,41358,10.82740944919967,Trump
ALABAMA,DALE,1045,14303,5170,19473,26.54958147178144,Trump
ALABAMA,DALLAS,1047,5524,12230,17754,68.88588487101498,Biden
ALABAMA,DEKALB,1049,24767,4281,29048,14.737675571467914,Trump
ALABAMA,ELMORE,1051,30164,10367,40531,25.577952678196937,Trump
ALABAMA,ESCAMBIA,1053,10869,4918,15787,31.152213846836002,Trump
ALABAMA,ETOWAH,1055,35528,11567,47095,24.560993736065402,Trump
ALABAMA,FAYETTE,1057,7300,1395,8695,16.04370327774583,Trump
ALABAMA,FRANKLIN,1059,10376,2086,12462,16.738886214090837,Trump
ALABAMA,GENEVA,1061,10848,1595,12443,12.818452141766453,Trump
ALABAMA,GREENE,1063,875,3884,4759,81.61378440848918,Biden
ALABAMA,HALE,1065,3192,4663,7855,59.36346276257161,Biden
ALABAMA,HENRY,1067,6607,2606,9213,28.286117442743947,Trump
ALABAMA,HOUSTON,1069,32618,12917,45535,28.36719007356978,Trump
ALABAMA,JACKSON,1071,19670,3717,23387,15.893445076324452,Trump
ALABAMA,JEFFERSON,1073,138843,181688,320531,56.68344091523129,Biden
ALABAMA,LAMAR,1075,6174,978,7152,13.674496644295303,Trump
ALABAMA,LAUDERDALE,1077,31721,11915,43636,27.305435878632323,Trump
ALABAMA,LAWRENCE,1079,12322,3562,15884,22.425081843364392,Trump
ALABAMA,LEE,1081,42221,27860,70081,39.753998944078994,Trump
ALABAMA,LIMESTONE,1083,34640,13672,48312,28.29938731578076,Trump
ALABAMA,LOWNDES,1085,1836,4972,6808,73.03172737955347,Biden
ALABAMA,MACON,1087,1541,7108,8649,82.18291131922766,Biden
ALABAMA,MADISON,1089,102780,87286,190066,45.92404743615376,Trump
ALABAMA,MARENGO,1091,5343,5488,10831,50.66937494229526,Biden
ALABAMA,MARION,1093,12205,1463,13668,10.703833772314896,Trump
ALABAMA,MARSHALL,1095,33191,5943,39134,15.186283027546379,Trump
ALABAMA,MOBILE,1097,101243,79474,180717,43.97704698506505,Trump
ALABAMA,MONROE,1099,6147,4455,10602,42.02037351443124,Trump
ALABAMA,MONTGOMERY,1101,33311,64529,97840,65.95359771054783,Biden
ALABAMA,MORGAN,1103,39664,13234,52898,25.01795909108095,Trump
ALABAMA,PERRY,1105,1339,3860,5199,74.24504712444701,Biden
ALABAMA,PICKENS,1107,5594,4022,9616,41.826123128119804,Trump
ALABAMA,PIKE,1109,8042,5636,13678,41.204854510893405,Trump
ALABAMA,RANDOLPH,1111,8559,2203,10762,20.470172830328934,Trump
ALABAMA,RUSSELL,1113,9864,11228,21092,53.233453442063336,Biden
ALABAMA,SHELBY,1117,79700,33268,112968,29.449047517881173,Trump
ALABAMA,ST. CLAIR,1115,36166,7744,43910,17.63607378729219,Trump
ALABAMA,SUMTER,1119,1598,4648,6246,74.41562600064042,Biden
ALABAMA,TALLADEGA,1121,22235,13138,35373,37.14132247759591,Trump
ALABAMA,TALLAPOOSA,1123,14963,5859,20822,28.13850734799731,Trump
ALABAMA,TUSCALOOSA,1125,51117,37765,88882,42.488917891136566,Trump
ALABAMA,WALKER,1127,26002,4834,30836,15.67648203398625,Trump
ALABAMA,WASHINGTON,1129,6564,2258,8822,25.59510315121288,Trump
ALABAMA,WILCOX,1131,1833,4048,5881,68.83183132120388,Biden
ALABAMA,WINSTON,1133,10195,974,11169,8.720565851911541,Trump
ALASKA,DISTRICT 1,2001,3511,3477,6988,49.75672581568403,Trump
ALASKA,DISTRICT 10,2010,8081,2727,10808,25.231310140636566,Trump
ALASKA,DISTRICT 11,2011,7096,3130,10226,30.608253471543122,Trump
ALASKA,DISTRICT 12,2012,7893,2957,10850,27.253456221198157,Trump
ALASKA,DISTRICT 13,2013,4652,2666,7318,36.430718775621756,Trump
ALASKA,DISTRICT 14,2014,6714,4261,10975,38.8246013667426,Trump
ALASKA,DISTRICT 15,2015,2671,2622,5293,49.53712450406197,Trump
ALASKA,DISTRICT 16,2016,3516,4274,7790,54.86521181001284,Biden
ALASKA,DISTRICT 17,2017,2810,4136,6946,59.54506190613302,Biden
ALASKA,DISTRICT 18,2018,2760,4681,7441,62.908211261927164,Biden
ALASKA,DISTRICT 19,2019,1975,3118,5093,61.221284115452576,Biden
ALASKA,DISTRICT 2,2002,3674,2104,5778,36.413984077535474,Trump
ALASKA,DISTRICT 20,2020,2383,4881,7264,67.19438325991189,Biden
ALASKA,DISTRICT 21,2021,3690,5414,9104,59.46836555360281,Biden
ALASKA,DISTRICT 22,2022,4684,4553,9237,49.290895312330846,Trump
ALASKA,DISTRICT 23,2023,3655,3810,7465,51.03817816476892,Biden
ALASKA,DISTRICT 24,2024,5378,4736,10114,46.82618153055171,Trump
ALASKA,DISTRICT 25,2025,4407,4600,9007,51.0713889197291,Biden
ALASKA,DISTRICT 26,2026,5243,4558,9801,46.505458626670745,Trump
ALASKA,DISTRICT 27,2027,4324,4844,9168,52.83595113438045,Biden
ALASKA,DISTRICT 28,2028,6162,6264,12426,50.410429744084986,Biden
ALASKA,DISTRICT 29,2029,7464,2985,10449,28.56732701693942,Trump
ALASKA,DISTRICT 3,2003,6076,1903,7979,23.850106529640307,Trump
ALASKA,DISTRICT 30,2030,7180,2638,9818,26.869016092890607,Trump
ALASKA,DISTRICT 31,2031,6971,5037,12008,41.94703530979347,Trump
ALASKA,DISTRICT 32,2032,4440,3506,7946,44.12282909640071,Trump
ALASKA,DISTRICT 33,2033,3059,7535,10594,71.12516518784217,Biden
ALASKA,DISTRICT 34,2034,4543,5763,10306,55.91888220454104,Biden
ALASKA,DISTRICT 35,2035,4769,5011,9780,51.237218813905926,Biden
ALASKA,DISTRICT 36,2036,5114,3796,8910,42.60381593714927,Trump
ALASKA,DISTRICT 37,2037,2358,2560,4918,52.05368035786905,Biden
ALASKA,DISTRICT 38,2038,1737,3202,4939,64.83093743672809,Biden
ALASKA,DISTRICT 39,2039,1939,3580,5519,64.86682369994564,Biden
ALASKA,DISTRICT 4,2004,4690,5345,10035,53.26357747882412,Biden
ALASKA,DISTRICT 40,2040,1994,2318,4312,53.7569573283859,Biden
ALASKA,DISTRICT 5,2005,4077,4204,8281,50.76681560198044,Biden
ALASKA,DISTRICT 6,2006,5770,3272,9042,36.186684361866845,Trump
ALASKA,DISTRICT 7,2007,7027,2215,9242,23.96667388011253,Trump
ALASKA,DISTRICT 8,2008,7618,1953,9571,20.405391286176993,Trump
ALASKA,DISTRICT 9,2009,7787,2769,10556,26.231527093596057,Trump
ALASKA,DISTRICT 99,2099,59,373,432,86.3425925925926,Biden
ARIZONA,APACHE,4001,11442,23293,34735,67.05916222829998,Biden
ARIZONA,COCHISE,4003,35557,23732,59289,40.02766111757662,Trump
ARIZONA,COCONINO,4005,27052,44698,71750,62.296864111498266,Biden
ARIZONA,GILA,4007,18377,8943,27320,32.734260614934115,Trump
ARIZONA,GRAHAM,4009,10749,4034,14783,27.288101197321247,Trump
ARIZONA,GREENLEE,4011,2433,1182,3615,32.697095435684645,Trump
ARIZONA,LA PAZ,4012,5129,2236,7365,30.35980991174474,Trump
ARIZONA,MARICOPA,4013,995665,1040774,2036439,51.107546064478235,Biden
ARIZONA,MOHAVE,4015,78535,24831,103366,24.02240582009558,Trump
ARIZONA,NAVAJO,4017,27657,23383,51040,45.81308777429467,Trump
ARIZONA,PIMA,4019,207758,304981,512739,59.48074946512748,Biden
ARIZONA,PINAL,4021,107077,75106,182183,41.22558087198037,Trump
ARIZONA,SANTA CRUZ,4023,6194,13138,19332,67.95985930064143,Biden
ARIZONA,YAVAPAI,4025,91527,49602,141129,35.14656803350126,Trump
ARIZONA,YUMA,4027,36534,32210,68744,46.85499825439311,Trump
ARKANSAS,ARKANSAS,5001,4304,1818,6122,29.696177719699445,Trump
ARKANSAS,ASHLEY,5003,5548,2125,7673,27.694513228202787,Trump
ARKANSAS,BAXTER,5005,15836,4635,20471,22.64178594108739,Trump
ARKANSAS,BENTON,5007,73965,42249,116214,36.35448396922918,Trump
ARKANSAS,BOONE,5009,13652,3064,16716,18.329743957884663,Trump
ARKANSAS,BRADLEY,5011,2335,1214,3549,34.20681882220344,Trump
ARKANSAS,CALHOUN,5013,1636,479,2115,22.64775413711584,Trump
ARKANSAS,CARROLL,5015,7424,4023,11447,35.14457936577269,Trump
ARKANSAS,CHICOT,5017,1752,2260,4012,56.33100697906281,Biden
ARKANSAS,CLARK,5019,4616,3438,8054,42.686863670225975,Trump
ARKANSAS,CLAY,5021,4086,962,5048,19.057052297939777,Trump
ARKANSAS,CLEBURNE,5023,10328,1988,12316,16.141604417018513,Trump
ARKANSAS,CLEVELAND,5025,2867,651,3518,18.504832291074475,Trump
ARKANSAS,COLUMBIA,5027,5500,2814,8314,33.846523935530435,Trump
ARKANSAS,CONWAY,5029,5694,2615,8309,31.471897941990612,Trump
ARKANSAS,CRAIGHEAD,5031,25558,11921,37479,31.807145334720776,Trump
ARKANSAS,CRAWFORD,5033,18607,4959,23566,21.043028091318,Trump
ARKANSAS,CRITTENDEN,5035,7333,8514,15847,53.72625733577333,Biden
ARKANSAS,CROSS,5037,4946,1772,6718,26.376897886275678,Trump
ARKANSAS,DALLAS,5039,1573,963,2536,37.97318611987382,Trump
ARKANSAS,DESHA,5041,1921,2016,3937,51.20650241300483,Biden
ARKANSAS,DREW,5043,4349,2426,6775,35.808118081180815,Trump
ARKANSAS,FAULKNER,5045,34421,18347,52768,34.76917828987265,Trump
ARKANSAS,FRANKLIN,5047,5677,1300,6977,18.632650136161676,Trump
ARKANSAS,FULTON,5049,3961,1035,4996,20.716573258606886,Trump
ARKANSAS,GARLAND,5051,29069,14045,43114,32.57642529108874,Trump
ARKANSAS,GRANT,5053,6794,1268,8062,15.728107169436864,Trump
ARKANSAS,GREENE,5055,12670,3058,15728,19.443031536113935,Trump
ARKANSAS,HEMPSTEAD,5057,4470,2138,6608,32.35472154963681,Trump
ARKANSAS,HOT SPRING,5059,9202,3082,12284,25.089547378704008,Trump
ARKANSAS,HOWARD,5061,3367,1340,4707,28.468238793286595,Trump
ARKANSAS,INDEPENDENCE,5063,11250,2806,14056,19.963005122367672,Trump
ARKANSAS,IZARD,5065,4631,1021,5652,18.064401981599435,Trump
ARKANSAS,JACKSON,5067,3593,1365,4958,27.531262605889474,Trump
ARKANSAS,JEFFERSON,5069,9521,14981,24502,61.1419475961146,Biden
ARKANSAS,JOHNSON,5071,6938,2283,9221,24.758702960633336,Trump
ARKANSAS,LAFAYETTE,5073,1757,839,2596,32.31895223420647,Trump
ARKANSAS,LAWRENCE,5075,4569,1080,5649,19.118428040361128,Trump
ARKANSAS,LEE,5077,1286,1423,2709,52.52860834256183,Biden
ARKANSAS,LINCOLN,5079,2729,1032,3761,27.439510768412656,Trump
ARKANSAS,LITTLE RIVER,5081,3715,1226,4941,24.812790933009513,Trump
ARKANSAS,LOGAN,5083,6441,1544,7985,19.33625547902317,Trump
ARKANSAS,LONOKE,5085,22884,6686,29570,22.61075414271221,Trump
ARKANSAS,MADISON,5087,5658,1563,7221,21.64520149563772,Trump
ARKANSAS,MARION,5089,5783,1531,7314,20.93245829915231,Trump
ARKANSAS,MILLER,5091,11920,4245,16165,26.260439220538203,Trump
ARKANSAS,MISSISSIPPI,5093,7296,4558,11854,38.4511557280243,Trump
ARKANSAS,MONROE,5095,1545,1147,2692,42.60772659732541,Trump
ARKANSAS,MONTGOMERY,5097,3046,731,3777,19.353984643897274,Trump
ARKANSAS,NEVADA,5099,2133,1076,3209,33.53069492053599,Trump
ARKANSAS,NEWTON,5101,3192,709,3901,18.174826967444247,Trump
ARKANSAS,OUACHITA,5103,5294,3995,9289,43.00785875767036,Trump
ARKANSAS,PERRY,5105,3479,1012,4491,22.533956802493876,Trump
ARKANSAS,PHILLIPS,5107,2417,3623,6040,59.98344370860927,Biden
ARKANSAS,PIKE,5109,3519,644,4163,15.469613259668508,Trump
ARKANSAS,POINSETT,5111,5918,1424,7342,19.395260147098885,Trump
ARKANSAS,POLK,5113,7035,1246,8281,15.046491969568892,Trump
ARKANSAS,POPE,5115,18081,5772,23853,24.198214061124386,Trump
ARKANSAS,PRAIRIE,5117,2786,654,3440,19.011627906976745,Trump
ARKANSAS,PULASKI,5119,63687,101947,165634,61.549561080454495,Biden
ARKANSAS,RANDOLPH,5121,5355,1215,6570,18.493150684931507,Trump
ARKANSAS,SALINE,5125,39556,16060,55616,28.87658227848101,Trump
ARKANSAS,SCOTT,5127,2962,483,3445,14.020319303338171,Trump
ARKANSAS,SEARCY,5129,3365,588,3953,14.874778649127245,Trump
ARKANSAS,SEBASTIAN,5131,31198,14487,45685,31.71062712049907,Trump
ARKANSAS,SEVIER,5133,3884,1116,5000,22.32,Trump
ARKANSAS,SHARP,5135,5938,1398,7336,19.056706652126497,Trump
ARKANSAS,ST. FRANCIS,5123,3242,3604,6846,52.643879637744675,Biden
ARKANSAS,STONE,5137,4616,1180,5796,20.358868184955142,Trump
ARKANSAS,UNION,5139,10478,5584,16062,34.76528452247541,Trump
ARKANSAS,VAN BUREN,5141,6034,1593,7627,20.886324898387308,Trump
ARKANSAS,WASHINGTON,5143,47504,43824,91328,47.985283812193416,Trump
ARKANSAS,WHITE,5145,24182,5978,30160,19.820954907161802,Trump
ARKANSAS,WOODRUFF,5147,1543,856,2399,35.68153397248854,Trump
ARKANSAS,YELL,5149,5226,1284,6510,19.723502304147466,Trump
CALIFORNIA,ALAMEDA,6001,136309,617659,753968,81.92111601553381,Biden
CALIFORNIA,ALPINE,6003,244,476,720,66.11111111111111,Biden
CALIFORNIA,AMADOR,6005,13585,8153,21738,37.50575029901555,Trump
CALIFORNIA,BUTTE,6007,48730,50426,99156,50.8552180402598,Biden
CALIFORNIA,CALAVERAS,6009,16518,10046,26564,37.81809968378256,Trump
CALIFORNIA,COLUSA,6011,4559,3239,7798,41.53629135675814,Trump
CALIFORNIA,CONTRA COSTA,6013,152877,416386,569263,73.1447503175158,Biden
CALIFORNIA,DEL NORTE,6015,6461,4677,11138,41.991380858322856,Trump
CALIFORNIA,EL DORADO,6017,61838,51621,113459,45.49749248627257,Trump
CALIFORNIA,FRESNO,6019,164464,193025,357489,53.9946683674183,Biden
CALIFORNIA,GLENN,6021,7063,3995,11058,36.127690359920415,Trump
CALIFORNIA,HUMBOLDT,6023,21770,44768,66538,67.28185397817789,Biden
CALIFORNIA,IMPERIAL,6025,20847,34678,55525,62.45475011256191,Biden
CALIFORNIA,INYO,6027,4620,4634,9254,50.07564296520424,Biden
CALIFORNIA,KERN,6029,164484,133366,297850,44.776229645794864,Trump
CALIFORNIA,KINGS,6031,24072,18699,42771,43.71887493862664,Trump
CALIFORNIA,LAKE,6033,13123,14941,28064,53.23902508551881,Biden
CALIFORNIA,LASSEN,6035,8970,2799,11769,23.782819270966097,Trump
CALIFORNIA,LOS ANGELES,6037,1145530,3028885,4174415,72.55831056567207,Biden
CALIFORNIA,MADERA,6039,29378,23168,52546,44.09089179005063,Trump
CALIFORNIA,MARIN,6041,24612,128288,152900,83.9032047089601,Biden
CALIFORNIA,MARIPOSA,6043,5950,4088,10038,40.72524407252441,Trump
CALIFORNIA,MENDOCINO,6045,13267,28782,42049,68.4487145948774,Biden
CALIFORNIA,MERCED,6047,39397,48991,88388,55.427207313209934,Biden
CALIFORNIA,MODOC,6049,3109,1150,4259,27.00164357830477,Trump
CALIFORNIA,MONO,6051,2513,4013,6526,61.492491572172845,Biden
CALIFORNIA,MONTEREY,6053,46299,113953,160252,71.10862890946758,Biden
CALIFORNIA,NAPA,6055,20676,49817,70493,70.66942817017292,Biden
CALIFORNIA,NEVADA,6057,26779,36359,63138,57.586556431942725,Biden
CALIFORNIA,ORANGE,6059,676498,814009,1490507,54.61289346510952,Biden
CALIFORNIA,PLACER,6061,122488,106869,229357,46.5950461507606,Trump
CALIFORNIA,PLUMAS,6063,6445,4561,11006,41.441032164274034,Trump
CALIFORNIA,RIVERSIDE,6065,449144,528340,977484,54.05101259969472,Biden
CALIFORNIA,SACRAMENTO,6067,259405,440808,700213,62.95341560353778,Biden
CALIFORNIA,SAN BENITO,6069,10590,17628,28218,62.47076334254731,Biden
CALIFORNIA,SAN BERNARDINO,6071,366257,455859,822116,55.449474283434455,Biden
CALIFORNIA,SAN DIEGO,6073,600094,964650,1564744,61.64906208299888,Biden
CALIFORNIA,SAN FRANCISCO,6075,56417,378156,434573,87.01783129646803,Biden
CALIFORNIA,SAN JOAQUIN,6077,121098,161137,282235,57.09320247311638,Biden
CALIFORNIA,SAN LUIS OBISPO,6079,67436,88310,155746,56.70129569940801,Biden
CALIFORNIA,SAN MATEO,6081,75584,291496,367080,79.40939304783699,Biden
CALIFORNIA,SANTA BARBARA,6083,65736,129963,195699,66.40963929299588,Biden
CALIFORNIA,SANTA CLARA,6085,214612,617967,832579,74.22322686495816,Biden
CALIFORNIA,SANTA CRUZ,6087,26937,114246,141183,80.92050742653151,Biden
CALIFORNIA,SHASTA,6089,60789,30000,90789,33.043650662525195,Trump
CALIFORNIA,SIERRA,6091,1142,730,1872,38.995726495726494,Trump
CALIFORNIA,SISKIYOU,6093,13290,9593,22883,41.92195079316523,Trump
CALIFORNIA,SOLANO,6095,69306,131639,200945,65.50996541342158,Biden
CALIFORNIA,SONOMA,6097,61825,199938,261763,76.38130675458335,Biden
CALIFORNIA,STANISLAUS,6099,104145,105841,209986,50.40383644623927,Biden
CALIFORNIA,SUTTER,6101,24375,17367,41742,41.60557711657324,Trump
CALIFORNIA,TEHAMA,6103,19141,8911,28052,31.7660059888778,Trump
CALIFORNIA,TRINITY,6105,3188,2851,6039,47.20980294750787,Trump
CALIFORNIA,TULARE,6107,77579,66105,143684,46.00721026697475,Trump
CALIFORNIA,TUOLUMNE,6109,17689,11978,29667,40.37482724913203,Trump
CALIFORNIA,VENTURA,6111,162207,251388,413595,60.78119899902078,Biden
CALIFORNIA,YOLO,6113,27292,67598,94890,71.23827589840869,Biden
CALIFORNIA,YUBA,6115,17676,11230,28906,38.850065730298205,Trump
COLORADO,ADAMS,8001,95657,134202,229859,58.38448788170139,Biden
COLORADO,ALAMOSA,8003,3813,3759,7572,49.64342313787638,Trump
COLORADO,ARAPAHOE,8005,127323,213607,340930,62.65421054175344,Biden
COLORADO,ARCHULETA,8007,5189,3738,8927,41.87296964265711,Trump
COLORADO,BACA,8009,1867,317,2184,14.514652014652016,Trump
COLORADO,BENT,8011,1503,732,2235,32.75167785234899,Trump
COLORADO,BOULDER,8013,42501,159089,201590,78.91710898358053,Biden
COLORADO,BROOMFIELD,8014,16295,29077,45372,64.08577977607335,Biden
COLORADO,CHAFFEE,8015,6222,7160,13382,53.50470781646989,Biden
COLORADO,CHEYENNE,8017,993,131,1124,11.654804270462634,Trump
COLORADO,CLEAR CREEK,8019,2754,3604,6358,56.68449197860963,Biden
COLORADO,CONEJOS,8021,2286,1959,4245,46.148409893992934,Trump
COLORADO,COSTILLA,8023,741,1311,2052,63.888888888888886,Biden
COLORADO,CROWLEY,8025,1271,437,1708,25.585480093676814,Trump
COLORADO,CUSTER,8027,2474,1112,3586,31.00948131622978,Trump
COLORADO,DELTA,8029,13081,5887,18968,31.036482496836776,Trump
COLORADO,DENVER,8031,71618,313293,384911,81.39362086300468,Biden
COLORADO,DOLORES,8033,1089,341,1430,23.846153846153847,Trump
COLORADO,DOUGLAS,8035,121270,104653,225923,46.32241958543398,Trump
COLORADO,EAGLE,8037,9892,18588,28480,65.26685393258427,Biden
COLORADO,EL PASO,8041,202828,161941,364769,44.39549413464412,Trump
COLORADO,ELBERT,8039,14027,4490,18517,24.247988335043473,Trump
COLORADO,FREMONT,8043,17517,7369,24886,29.61102627983605,Trump
COLORADO,GARFIELD,8045,14717,15427,30144,51.17768046709129,Biden
COLORADO,GILPIN,8047,1833,2223,4056,54.807692307692314,Biden
COLORADO,GRAND,8049,4883,4710,9593,49.09830084436568,Trump
COLORADO,GUNNISON,8051,3735,7132,10867,65.62988865372228,Biden
COLORADO,HINSDALE,8053,353,255,608,41.94078947368421,Trump
COLORADO,HUERFANO,8055,2203,2076,4279,48.51600841318065,Trump
COLORADO,JACKSON,8057,681,175,856,20.443925233644862,Trump
COLORADO,JEFFERSON,8059,148417,218396,366813,59.538784067085956,Biden
COLORADO,KIOWA,8061,795,98,893,10.974244120940648,Trump
COLORADO,KIT CARSON,8063,3144,662,3806,17.393589069889646,Trump
COLORADO,LA PLATA,8067,14233,20548,34781,59.07823236824703,Biden
COLORADO,LAKE,8065,1497,2303,3800,60.60526315789474,Biden
COLORADO,LARIMER,8069,91489,126120,217609,57.95716169827535,Biden
COLORADO,LAS ANIMAS,8071,4284,3497,7781,44.942809407531165,Trump
COLORADO,LINCOLN,8073,2135,470,2605,18.042226487523994,Trump
COLORADO,LOGAN,8075,8087,2218,10305,21.523532265890346,Trump
COLORADO,MESA,8077,56894,31536,88430,35.66210562026462,Trump
COLORADO,MINERAL,8079,427,317,744,42.60752688172043,Trump
COLORADO,MOFFAT,8081,5670,1203,6873,17.503273679615887,Trump
COLORADO,MONTEZUMA,8083,9306,5836,15142,38.54180425307093,Trump
COLORADO,MONTROSE,8085,16770,7687,24457,31.43067424459255,Trump
COLORADO,MORGAN,8087,9593,3876,13469,28.777192070680822,Trump
COLORADO,OTERO,8089,5756,3605,9361,38.51084285866895,Trump
COLORADO,OURAY,8091,1577,2365,3942,59.9949264332826,Biden
COLORADO,PARK,8093,6991,4903,11894,41.222465108458046,Trump
COLORADO,PHILLIPS,8095,1958,486,2444,19.885433715220948,Trump
COLORADO,PITKIN,8097,2780,8989,11769,76.3786218030419,Biden
COLORADO,PROWERS,8099,4008,1458,5466,26.67398463227223,Trump
COLORADO,PUEBLO,8101,42252,43772,86024,50.883474379243,Biden
COLORADO,RIO BLANCO,8103,3061,561,3622,15.48868028713418,Trump
COLORADO,RIO GRANDE,8105,3660,2495,6155,40.53614947197401,Trump
COLORADO,ROUTT,8107,5925,10582,16507,64.10613679045254,Biden
COLORADO,SAGUACHE,8109,1413,1884,3297,57.14285714285714,Biden
COLORADO,SAN JUAN,8111,202,342,544,62.86764705882353,Biden
COLORADO,SAN MIGUEL,8113,1136,3924,5060,77.5494071146245,Biden
COLORADO,SEDGWICK,8115,1121,301,1422,21.16736990154712,Trump
COLORADO,SUMMIT,8117,5322,12631,17953,70.35592937113574,Biden
COLORADO,TELLER,8119,11241,5278,16519,31.951086627519825,Trump
COLORADO,WASHINGTON,8121,2595,369,2964,12.449392712550607,Trump
COLORADO,WELD,8123,96145,66060,162205,40.72624148454116,Trump
COLORADO,YUMA,8125,4107,785,4892,16.046606704824203,Trump
CONNECTICUT,FAIRFIELD,9001,168445,297505,465950,63.84912544264406,Biden
CONNECTICUT,HARTFORD,9003,159024,283368,442392,64.05359952259535,Biden
CONNECTICUT,LITCHFIELD,9005,55601,50164,105765,47.42967900534203,Trump
CONNECTICUT,MIDDLESEX,9007,40665,56848,97513,58.29786797657748,Biden
CONNECTICUT,NEW HAVEN,9009,169893,242630,412523,58.81611449543419,Biden
CONNECTICUT,NEW LONDON,9011,57110,79459,136569,58.18231077330873,Biden
CONNECTICUT,TOLLAND,9013,34838,44151,78989,55.89512463760777,Biden
CONNECTICUT,WINDHAM,9015,29141,26706,55847,47.81993661253067,Trump
DELAWARE,KENT,10001,41009,44552,85561,52.07045265950608,Biden
DELAWARE,NEW CASTLE,10003,88364,195034,283398,68.81982229938109,Biden
DELAWARE,SUSSEX,10005,71230,56682,127912,44.3132778785415,Trump
DISTRICT OF COLUMBIA,DISTRICT OF COLUMBIA,NA,18586,317323,335909,94.46695384761944,Biden
FLORIDA,ALACHUA,12001,50972,89704,140676,63.76638516875658,Biden
FLORIDA,BAKER,12003,11911,2037,13948,14.604244336105534,Trump
FLORIDA,BAY,12005,66097,25614,91711,27.929037956188463,Trump
FLORIDA,BRADFORD,12007,10334,3160,13494,23.417815325329776,Trump
FLORIDA,BREVARD,12009,207883,148549,356432,41.67667325043767,Trump
FLORIDA,BROWARD,12011,333409,618752,952161,64.98396804742055,Biden
FLORIDA,CALHOUN,12013,5274,1209,6483,18.648773715872284,Trump
FLORIDA,CHARLOTTE,12015,73243,42273,115516,36.59493057238824,Trump
FLORIDA,CITRUS,12017,65352,27092,92444,29.30639089611008,Trump
FLORIDA,CLAY,12019,84480,38317,122797,31.203531030888378,Trump
FLORIDA,COLLIER,12021,128950,77621,206571,37.57594241205203,Trump
FLORIDA,COLUMBIA,12023,23836,8914,32750,27.218320610687023,Trump
FLORIDA,DESOTO,12027,8313,4259,12572,33.876869233216674,Trump
FLORIDA,DIXIE,12029,6759,1365,8124,16.802067946824227,Trump
FLORIDA,DUVAL,12031,233762,252556,486318,51.932274766716425,Biden
FLORIDA,ESCAMBIA,12033,96674,70929,167603,42.31964821632071,Trump
FLORIDA,FLAGLER,12035,43043,28161,71204,39.54974439638222,Trump
FLORIDA,FRANKLIN,12037,4675,2120,6795,31.199411331861665,Trump
FLORIDA,GADSDEN,12039,7465,16153,23618,68.39275129138792,Biden
FLORIDA,GILCHRIST,12041,7895,1700,9595,17.717561229807192,Trump
FLORIDA,GLADES,12043,3782,1385,5167,26.804722275982197,Trump
FLORIDA,GULF,12045,6113,1985,8098,24.5122252408002,Trump
FLORIDA,HAMILTON,12047,3815,1963,5778,33.973693319487715,Trump
FLORIDA,HARDEE,12049,6122,2298,8420,27.29216152019002,Trump
FLORIDA,HENDRY,12051,7906,4929,12835,38.402804830541484,Trump
FLORIDA,HERNANDO,12053,70412,37519,107931,34.76202388563063,Trump
FLORIDA,HIGHLANDS,12055,34873,16938,51811,32.69189940360155,Trump
FLORIDA,HILLSBOROUGH,12057,327398,376367,703765,53.47907327019673,Biden
FLORIDA,HOLMES,12059,8080,924,9004,10.262105730786317,Trump
FLORIDA,INDIAN RIVER,12061,58872,37844,96716,39.12899623640349,Trump
FLORIDA,JACKSON,12063,15488,6766,22254,30.403522962164104,Trump
FLORIDA,JEFFERSON,12065,4479,3897,8376,46.52578796561605,Trump
FLORIDA,LAFAYETTE,12067,3128,510,3638,14.018691588785046,Trump
FLORIDA,LAKE,12069,125859,83505,209364,39.88508052960395,Trump
FLORIDA,LEE,12071,233247,157695,390942,40.33718556716853,Trump
FLORIDA,LEON,12073,57453,103517,160970,64.30825619680685,Biden
FLORIDA,LEVY,12075,16749,6205,22954,27.03232552060643,Trump
FLORIDA,LIBERTY,12077,2846,694,3540,19.6045197740113,Trump
FLORIDA,MADISON,12079,5576,3747,9323,40.19092566770353,Trump
FLORIDA,MANATEE,12081,124987,90166,215153,41.90785162186909,Trump
FLORIDA,MARION,12083,127826,74858,202684,36.93335438416451,Trump
FLORIDA,MARTIN,12085,61168,36893,98061,37.622500280437684,Trump
FLORIDA,MIAMI-DADE,12086,532833,617864,1150697,53.694760653760284,Biden
FLORIDA,MONROE,12087,25693,21881,47574,45.99360995501745,Trump
FLORIDA,NASSAU,12089,42566,15564,58130,26.77447101324617,Trump
FLORIDA,OKALOOSA,12091,79798,34248,114046,30.029987899619453,Trump
FLORIDA,OKEECHOBEE,12093,11470,4390,15860,27.679697351828498,Trump
FLORIDA,ORANGE,12095,245398,395014,640412,61.68123020805356,Biden
FLORIDA,OSCEOLA,12097,73480,97297,170777,56.973128700000586,Biden
FLORIDA,PALM BEACH,12099,334711,433572,768283,56.43389219857787,Biden
FLORIDA,PASCO,12101,179621,119073,298694,39.864543646675195,Trump
FLORIDA,PINELLAS,12103,276209,277450,553659,50.11207259341941,Biden
FLORIDA,POLK,12105,194586,145049,339635,42.70731815036731,Trump
FLORIDA,PUTNAM,12107,25514,10527,36041,29.208401542687497,Trump
FLORIDA,SANTA ROSA,12113,77385,27612,104997,26.2978942255493,Trump
FLORIDA,SARASOTA,12115,148370,120110,268480,44.73703814064363,Trump
FLORIDA,SEMINOLE,12117,125241,132528,257769,51.41347485539378,Biden
FLORIDA,ST. JOHNS,12109,110946,63850,174796,36.52829584201012,Trump
FLORIDA,ST. LUCIE,12111,86831,84137,170968,49.212133264704505,Trump
FLORIDA,SUMTER,12119,62761,29341,92102,31.85707150767627,Trump
FLORIDA,SUWANNEE,12121,16410,4485,20895,21.46446518305815,Trump
FLORIDA,TAYLOR,12123,7751,2299,10050,22.87562189054726,Trump
FLORIDA,UNION,12125,5133,1053,6186,17.02230843840931,Trump
FLORIDA,VOLUSIA,12127,173821,130575,304396,42.89642439453869,Trump
FLORIDA,WAKULLA,12129,12874,5351,18225,29.36076817558299,Trump
FLORIDA,WALTON,12131,32947,10338,43285,23.88356243502368,Trump
FLORIDA,WASHINGTON,12133,9876,2347,12223,19.2015053587499,Trump
GEORGIA,APPLING,13001,6526,1779,8305,21.420830824804334,Trump
GEORGIA,ATKINSON,13003,2300,825,3125,26.400000000000002,Trump
GEORGIA,BACON,13005,4018,625,4643,13.46112427309929,Trump
GEORGIA,BAKER,13007,897,652,1549,42.0916720464816,Trump
GEORGIA,BALDWIN,13009,8903,9140,18043,50.656764396164725,Biden
GEORGIA,BANKS,13011,7795,932,8727,10.6795004010542,Trump
GEORGIA,BARROW,13013,26804,10453,37257,28.056472609174115,Trump
GEORGIA,BARTOW,13015,37674,12092,49766,24.297713298235742,Trump
GEORGIA,BEN HILL,13017,4110,2392,6502,36.78868040602891,Trump
GEORGIA,BERRIEN,13019,6419,1269,7688,16.50624349635796,Trump
GEORGIA,BIBB,13021,26585,43468,70053,62.050162020184715,Biden
GEORGIA,BLECKLEY,13023,4328,1311,5639,23.24880297925164,Trump
GEORGIA,BRANTLEY,13025,6991,699,7690,9.089726918075423,Trump
GEORGIA,BROOKS,13027,4260,2790,7050,39.57446808510638,Trump
GEORGIA,BRYAN,13029,14244,6739,20983,32.11647524186246,Trump
GEORGIA,BULLOCH,13031,18386,11243,29629,37.94593135104121,Trump
GEORGIA,BURKE,13033,5400,5209,10609,49.09982090677726,Trump
GEORGIA,BUTTS,13035,8406,3274,11680,28.03082191780822,Trump
GEORGIA,CALHOUN,13037,923,1260,2183,57.71873568483738,Biden
GEORGIA,CAMDEN,13039,15251,7967,23218,34.31389439228185,Trump
GEORGIA,CANDLER,13043,3133,1269,4402,28.82780554293503,Trump
GEORGIA,CARROLL,13045,37476,16238,53714,30.23047994936143,Trump
GEORGIA,CATOOSA,13047,25167,6932,32099,21.595688339200596,Trump
GEORGIA,CHARLTON,13049,3419,1103,4522,24.39186200796108,Trump
GEORGIA,CHATHAM,13051,53237,78254,131491,59.51281836779704,Biden
GEORGIA,CHATTAHOOCHEE,13053,880,667,1547,43.11570782159018,Trump
GEORGIA,CHATTOOGA,13055,8064,1854,9918,18.69328493647913,Trump
GEORGIA,CHEROKEE,13057,99587,42794,142381,30.0559765699075,Trump
GEORGIA,CLARKE,13059,14446,36048,50494,71.39066027646848,Biden
GEORGIA,CLAY,13061,637,790,1427,55.36089698668535,Biden
GEORGIA,CLAYTON,13063,15813,95476,111289,85.79104853130139,Biden
GEORGIA,CLINCH,13065,2105,747,2852,26.192145862552596,Trump
GEORGIA,COBB,13067,165459,221846,387305,57.27940511999587,Biden
GEORGIA,COFFEE,13069,10578,4511,15089,29.895950692557495,Trump
GEORGIA,COLQUITT,13071,11777,4187,15964,26.22776246554748,Trump
GEORGIA,COLUMBIA,13073,50013,29236,79249,36.891317240596095,Trump
GEORGIA,COOK,13075,4900,2059,6959,29.58758442304929,Trump
GEORGIA,COWETA,13077,51501,24210,75711,31.97685937314261,Trump
GEORGIA,CRAWFORD,13079,4428,1615,6043,26.725136521595232,Trump
GEORGIA,CRISP,13081,4987,2986,7973,37.451398469835695,Trump
GEORGIA,DADE,13083,6066,1261,7327,17.21031800191074,Trump
GEORGIA,DAWSON,13085,13398,2486,15884,15.650969529085874,Trump
GEORGIA,DECATUR,13087,6758,4780,11538,41.42832379961865,Trump
GEORGIA,DEKALB,13089,58373,308227,366600,84.0771958537916,Biden
GEORGIA,DODGE,13091,5843,2171,8014,27.090092338407786,Trump
GEORGIA,DOOLY,13093,2159,1911,4070,46.95331695331696,Trump
GEORGIA,DOUGHERTY,13095,10454,24577,35031,70.15786018098255,Biden
GEORGIA,DOUGLAS,13097,25451,42809,68260,62.71462056841488,Biden
GEORGIA,EARLY,13099,2722,2437,5159,47.23783679007559,Trump
GEORGIA,ECHOLS,13101,1256,167,1423,11.735769501054111,Trump
GEORGIA,EFFINGHAM,13103,23358,7720,31078,24.84072334127035,Trump
GEORGIA,ELBERT,13105,6226,2879,9105,31.619989017023613,Trump
GEORGIA,EMANUEL,13107,6551,2884,9435,30.567037625861154,Trump
GEORGIA,EVANS,13109,2888,1324,4212,31.433998100664766,Trump
GEORGIA,FANNIN,13111,12169,2571,14740,17.442333785617368,Trump
GEORGIA,FAYETTE,13113,37952,33065,71017,46.5592745398989,Trump
GEORGIA,FLOYD,13115,29123,12008,41131,29.19452481096983,Trump
GEORGIA,FORSYTH,13117,85122,42203,127325,33.14588651089731,Trump
GEORGIA,FRANKLIN,13119,9069,1593,10662,14.94091164884637,Trump
GEORGIA,FULTON,13121,137240,381144,518384,73.52541745115589,Biden
GEORGIA,GILMER,13123,13429,2932,16361,17.92066499602714,Trump
GEORGIA,GLASCOCK,13125,1403,155,1558,9.948652118100128,Trump
GEORGIA,GLYNN,13127,25616,15879,41495,38.26726111579708,Trump
GEORGIA,GORDON,13129,19405,4384,23789,18.42868552692421,Trump
GEORGIA,GRADY,13131,7034,3619,10653,33.9716511780719,Trump
GEORGIA,GREENE,13133,7068,4088,11156,36.64395840803155,Trump
GEORGIA,GWINNETT,13135,166413,241827,408240,59.2364785420341,Biden
GEORGIA,HABERSHAM,13137,16637,3563,20200,17.638613861386137,Trump
GEORGIA,HALL,13139,64170,25031,89201,28.06134460376005,Trump
GEORGIA,HANCOCK,13141,1159,2985,4144,72.03185328185329,Biden
GEORGIA,HARALSON,13143,12331,1792,14123,12.688522268639806,Trump
GEORGIA,HARRIS,13145,14319,5457,19776,27.594053398058254,Trump
GEORGIA,HART,13147,9464,3157,12621,25.013865779256793,Trump
GEORGIA,HEARD,13149,4516,824,5340,15.430711610486892,Trump
GEORGIA,HENRY,13151,48187,73276,121463,60.327836460485905,Biden
GEORGIA,HOUSTON,13153,41534,32232,73766,43.69492720223409,Trump
GEORGIA,IRWIN,13155,3134,1008,4142,24.33606953162723,Trump
GEORGIA,JACKSON,13157,29497,7642,37139,20.576752201190125,Trump
GEORGIA,JASPER,13159,5822,1761,7583,23.222998813134645,Trump
GEORGIA,JEFF DAVIS,13161,4695,1028,5723,17.962607024287962,Trump
GEORGIA,JEFFERSON,13163,3537,4061,7598,53.44827586206896,Biden
GEORGIA,JENKINS,13165,2161,1266,3427,36.94193171870441,Trump
GEORGIA,JOHNSON,13167,2850,1222,4072,30.009823182711198,Trump
GEORGIA,JONES,13169,9965,4888,14853,32.9091765973204,Trump
GEORGIA,LAMAR,13171,6330,2615,8945,29.234209055338177,Trump
GEORGIA,LANIER,13173,2509,1019,3528,28.883219954648524,Trump
GEORGIA,LAURENS,13175,14493,8073,22566,35.775059824514756,Trump
GEORGIA,LEE,13177,12007,4558,16565,27.515846664654394,Trump
GEORGIA,LIBERTY,13179,7959,13099,21058,62.20438788109032,Biden
GEORGIA,LINCOLN,13181,3179,1435,4614,31.100996965756394,Trump
GEORGIA,LONG,13183,3528,2033,5561,36.55817299046934,Trump
GEORGIA,LOWNDES,13185,25691,20117,45808,43.915909884736294,Trump
GEORGIA,LUMPKIN,13187,12163,3126,15289,20.446072339590554,Trump
GEORGIA,MACON,13193,1783,2857,4640,61.57327586206897,Biden
GEORGIA,MADISON,13195,11326,3411,14737,23.145823437606026,Trump
GEORGIA,MARION,13197,2275,1311,3586,36.55883993307306,Trump
GEORGIA,MCDUFFIE,13189,6169,4168,10337,40.321176356776625,Trump
GEORGIA,MCINTOSH,13191,4016,2612,6628,39.40856970428485,Trump
GEORGIA,MERIWETHER,13199,6524,4287,10811,39.65405605401905,Trump
GEORGIA,MILLER,13201,2066,749,2815,26.607460035523978,Trump
GEORGIA,MITCHELL,13205,4935,3995,8930,44.73684210526316,Trump
GEORGIA,MONROE,13207,11060,4384,15444,28.386428386428385,Trump
GEORGIA,MONTGOMERY,13209,2960,979,3939,24.854023863924855,Trump
GEORGIA,MORGAN,13211,8230,3355,11585,28.95986189037549,Trump
GEORGIA,MURRAY,13213,12943,2302,15245,15.10003279763857,Trump
GEORGIA,MUSCOGEE,13215,30049,49529,79578,62.239563698509635,Biden
GEORGIA,NEWTON,13217,23869,29794,53663,55.52056351676201,Biden
GEORGIA,OCONEE,13219,16595,8162,24757,32.96845336672457,Trump
GEORGIA,OGLETHORPE,13221,5593,2436,8029,30.340017436791634,Trump
GEORGIA,PAULDING,13223,54525,29704,84229,35.265763573116146,Trump
GEORGIA,PEACH,13225,6502,5920,12422,47.657382064079854,Trump
GEORGIA,PICKENS,13227,14075,2808,16883,16.632115145412545,Trump
GEORGIA,PIERCE,13229,7899,1100,8999,12.22358039782198,Trump
GEORGIA,PIKE,13231,9127,1505,10632,14.155379984951091,Trump
GEORGIA,POLK,13233,13589,3658,17247,21.209485707659304,Trump
GEORGIA,PULASKI,13235,2805,1217,4022,30.258577821979117,Trump
GEORGIA,PUTNAM,13237,8291,3448,11739,29.372178209387513,Trump
GEORGIA,QUITMAN,13239,604,497,1101,45.14078110808356,Trump
GEORGIA,RABUN,13241,7474,1984,9458,20.97695072954113,Trump
GEORGIA,RANDOLPH,13243,1391,1671,3062,54.57217504898759,Biden
GEORGIA,RICHMOND,13245,26781,59124,85905,68.82486467609569,Biden
GEORGIA,ROCKDALE,13247,13012,31244,44256,70.59833694866234,Biden
GEORGIA,SCHLEY,13249,1800,462,2262,20.424403183023873,Trump
GEORGIA,SCREVEN,13251,3916,2661,6577,40.45917591607115,Trump
GEORGIA,SEMINOLE,13253,2611,1254,3865,32.44501940491592,Trump
GEORGIA,SPALDING,13255,18057,11784,29841,39.48929325424751,Trump
GEORGIA,STEPHENS,13257,9368,2385,11753,20.292691227771634,Trump
GEORGIA,STEWART,13259,801,1182,1983,59.60665658093798,Biden
GEORGIA,SUMTER,13261,5732,6318,12050,52.43153526970954,Biden
GEORGIA,TALBOT,13263,1392,2114,3506,60.2966343411295,Biden
GEORGIA,TALIAFERRO,13265,360,561,921,60.91205211726385,Biden
GEORGIA,TATTNALL,13267,6053,2061,8114,25.400542272615233,Trump
GEORGIA,TAYLOR,13269,2418,1387,3805,36.452036793692514,Trump
GEORGIA,TELFAIR,13271,2825,1487,4312,34.48515769944341,Trump
GEORGIA,TERRELL,13273,2004,2376,4380,54.24657534246575,Biden
GEORGIA,THOMAS,13275,12954,8708,21662,40.199427569014865,Trump
GEORGIA,TIFT,13277,10784,5322,16106,33.04358624115237,Trump
GEORGIA,TOOMBS,13279,7872,2939,10811,27.185274257700492,Trump
GEORGIA,TOWNS,13281,6384,1550,7934,19.536173430804133,Trump
GEORGIA,TREUTLEN,13283,2101,952,3053,31.18244349819849,Trump
GEORGIA,TROUP,13285,18143,11578,29721,38.955620604959456,Trump
GEORGIA,TURNER,13287,2349,1410,3759,37.50997605746209,Trump
GEORGIA,TWIGGS,13289,2370,2044,4414,46.3072043497961,Trump
GEORGIA,UNION,13291,12651,2801,15452,18.12710328760031,Trump
GEORGIA,UPSON,13293,8608,4201,12809,32.79725193223515,Trump
GEORGIA,WALKER,13295,23174,5769,28943,19.932280689631344,Trump
GEORGIA,WALTON,13297,37842,12682,50524,25.10094212651413,Trump
GEORGIA,WARE,13299,9865,4211,14076,29.916169366297247,Trump
GEORGIA,WARREN,13301,1166,1469,2635,55.74952561669829,Biden
GEORGIA,WASHINGTON,13303,4663,4730,9393,50.35664856808262,Biden
GEORGIA,WAYNE,13305,9987,2687,12674,21.20088369891116,Trump
GEORGIA,WEBSTER,13307,748,639,1387,46.0706560922855,Trump
GEORGIA,WHEELER,13309,1583,689,2272,30.325704225352112,Trump
GEORGIA,WHITE,13311,12222,2411,14633,16.476457322490262,Trump
GEORGIA,WHITFIELD,13313,25636,10670,36306,29.389081694485757,Trump
GEORGIA,WILCOX,13315,2403,862,3265,26.401225114854515,Trump
GEORGIA,WILKES,13317,2823,2160,4983,43.34738109572547,Trump
GEORGIA,WILKINSON,13319,2664,2075,4739,43.785608778223256,Trump
GEORGIA,WORTH,13321,6830,2395,9225,25.962059620596207,Trump
HAWAII,HAWAII,15001,26897,58731,85628,68.58854580277479,Biden
HAWAII,HONOLULU,15003,136250,238866,375116,63.67790230222118,Biden
HAWAII,KAUAI,15007,11582,21225,32807,64.69655866126132,Biden
HAWAII,MAUI,15009,22126,47305,69431,68.13239043078741,Biden
IDAHO,ADA,16001,130699,120539,251238,47.978012880217165,Trump
IDAHO,ADAMS,16003,1941,591,2532,23.341232227488153,Trump
IDAHO,BANNOCK,16005,23331,14682,38013,38.62362875858259,Trump
IDAHO,BEAR LAKE,16007,2914,350,3264,10.723039215686274,Trump
IDAHO,BENEWAH,16009,3878,977,4855,20.12358393408857,Trump
IDAHO,BINGHAM,16011,15295,4124,19419,21.23693290076729,Trump
IDAHO,BLAINE,16013,4032,8919,12951,68.86726893676163,Biden
IDAHO,BOISE,16015,3485,1204,4689,25.677116656003413,Trump
IDAHO,BONNER,16017,18369,8310,26679,31.14809400652198,Trump
IDAHO,BONNEVILLE,16019,37805,14254,52059,27.380472156591562,Trump
IDAHO,BOUNDARY,16021,4937,1220,6157,19.814844891992852,Trump
IDAHO,BUTTE,16023,1202,188,1390,13.525179856115107,Trump
IDAHO,CAMAS,16025,507,149,656,22.713414634146343,Trump
IDAHO,CANYON,16027,61759,25881,87640,29.531036056595163,Trump
IDAHO,CARIBOU,16029,2906,431,3337,12.91579262810908,Trump
IDAHO,CASSIA,16031,7907,1464,9371,15.622665670686159,Trump
IDAHO,CLARK,16033,264,41,305,13.442622950819672,Trump
IDAHO,CLEARWATER,16035,3453,877,4330,20.2540415704388,Trump
IDAHO,CUSTER,16037,2089,603,2692,22.399702823179794,Trump
IDAHO,ELMORE,16039,7246,2601,9847,26.414136285162993,Trump
IDAHO,FRANKLIN,16041,5845,657,6502,10.104583205167641,Trump
IDAHO,FREMONT,16043,5548,998,6546,15.245951726245035,Trump
IDAHO,GEM,16045,7951,1803,9754,18.48472421570638,Trump
IDAHO,GOODING,16047,4659,1256,5915,21.234150464919697,Trump
IDAHO,IDAHO,16049,7826,1561,9387,16.62938105891126,Trump
IDAHO,JEFFERSON,16051,12099,1661,13760,12.071220930232558,Trump
IDAHO,JEROME,16053,5734,1893,7627,24.819719417857613,Trump
IDAHO,KOOTENAI,16055,62837,24312,87149,27.897049880090417,Trump
IDAHO,LATAH,16057,9472,10236,19708,51.93829916785062,Biden
IDAHO,LEMHI,16059,3592,1032,4624,22.318339100346023,Trump
IDAHO,LEWIS,16061,1489,349,1838,18.98803046789989,Trump
IDAHO,LINCOLN,16063,1469,414,1883,21.986192246415296,Trump
IDAHO,MADISON,16065,13559,2666,16225,16.431432973805855,Trump
IDAHO,MINIDOKA,16067,6265,1550,7815,19.833653230966092,Trump
IDAHO,NEZ PERCE,16069,13738,6686,20424,32.73599686643165,Trump
IDAHO,ONEIDA,16071,2148,249,2397,10.387984981226534,Trump
IDAHO,OWYHEE,16073,3819,816,4635,17.60517799352751,Trump
IDAHO,PAYETTE,16075,8862,2161,11023,19.60446339472013,Trump
IDAHO,POWER,16077,2116,865,2981,29.01710835290171,Trump
IDAHO,SHOSHONE,16079,4216,1693,5909,28.651210018615668,Trump
IDAHO,TETON,16081,2858,3318,6176,53.72409326424871,Biden
IDAHO,TWIN FALLS,16083,25897,9391,35288,26.612446157333935,Trump
IDAHO,VALLEY,16085,3947,2976,6923,42.98714430160335,Trump
IDAHO,WASHINGTON,16087,4154,1073,5227,20.528027549263438,Trump
ILLINOIS,ADAMS,17001,24220,8633,32853,26.277661096399115,Trump
ILLINOIS,ALEXANDER,17003,1486,1114,2600,42.84615384615385,Trump
ILLINOIS,BOND,17005,5625,2288,7913,28.914444584860355,Trump
ILLINOIS,BOONE,17007,13883,10542,24425,43.16069600818833,Trump
ILLINOIS,BROWN,17009,1931,486,2417,20.10757136946628,Trump
ILLINOIS,BUREAU,17011,10411,6669,17080,39.04566744730679,Trump
ILLINOIS,CALHOUN,17013,2046,677,2723,24.862284245317664,Trump
ILLINOIS,CARROLL,17015,5105,2748,7853,34.99299630714376,Trump
ILLINOIS,CASS,17017,3625,1615,5240,30.820610687022903,Trump
ILLINOIS,CHAMPAIGN,17019,35285,57067,92352,61.79292273042273,Biden
ILLINOIS,CHRISTIAN,17021,11563,4335,15898,27.267580827777078,Trump
ILLINOIS,CLARK,17023,6226,1993,8219,24.248692054994525,Trump
ILLINOIS,CLAY,17025,5629,1129,6758,16.706126072802604,Trump
ILLINOIS,CLINTON,17027,14304,4493,18797,23.902750438899826,Trump
ILLINOIS,COLES,17029,14037,8067,22104,36.4956568946797,Trump
ILLINOIS,COOK,17031,558269,1725973,2284242,75.5599888278037,Biden
ILLINOIS,CRAWFORD,17033,7043,2202,9245,23.818280151433207,Trump
ILLINOIS,CUMBERLAND,17035,4601,1142,5743,19.885077485634685,Trump
ILLINOIS,DE WITT,17039,5632,2191,7823,28.007158379138435,Trump
ILLINOIS,DEKALB,17037,21905,24643,46548,52.941050098822714,Biden
ILLINOIS,DOUGLAS,17041,6227,2335,8562,27.271665498715254,Trump
ILLINOIS,DUPAGE,17043,193611,281222,474833,59.22545400172271,Biden
ILLINOIS,EDGAR,17045,6193,1887,8080,23.353960396039604,Trump
ILLINOIS,EDWARDS,17047,2833,488,3321,14.694369165913882,Trump
ILLINOIS,EFFINGHAM,17049,15006,3716,18722,19.848306804828546,Trump
ILLINOIS,FAYETTE,17051,8055,1826,9881,18.47991094018824,Trump
ILLINOIS,FORD,17053,5048,1754,6802,25.78653337253749,Trump
ILLINOIS,FRANKLIN,17055,13622,4760,18382,25.894897182025893,Trump
ILLINOIS,FULTON,17057,9867,6503,16370,39.725106902871104,Trump
ILLINOIS,GALLATIN,17059,2019,622,2641,23.55168496781522,Trump
ILLINOIS,GREENE,17061,4770,1349,6119,22.046085961758457,Trump
ILLINOIS,GRUNDY,17063,16523,9626,26149,36.81211518604918,Trump
ILLINOIS,HAMILTON,17065,3432,824,4256,19.360902255639097,Trump
ILLINOIS,HANCOCK,17067,6906,2315,9221,25.105736904891007,Trump
ILLINOIS,HARDIN,17069,1691,449,2140,20.981308411214954,Trump
ILLINOIS,HENDERSON,17071,2394,1187,3581,33.14716559620218,Trump
ILLINOIS,HENRY,17073,15300,9797,25097,39.036538231661154,Trump
ILLINOIS,IROQUOIS,17075,10877,2908,13785,21.095393543706926,Trump
ILLINOIS,JACKSON,17077,10890,11181,22071,50.65923610167188,Biden
ILLINOIS,JASPER,17079,4494,1007,5501,18.30576258862025,Trump
ILLINOIS,JEFFERSON,17081,12476,4608,17084,26.972605947084993,Trump
ILLINOIS,JERSEY,17083,8712,2961,11673,25.36622976098689,Trump
ILLINOIS,JO DAVIESS,17085,7166,5109,12275,41.621181262729124,Trump
ILLINOIS,JOHNSON,17087,5059,1281,6340,20.20504731861199,Trump
ILLINOIS,KANE,17089,96775,130166,226941,57.35675792386567,Biden
ILLINOIS,KANKAKEE,17091,28532,20271,48803,41.536380960186875,Trump
ILLINOIS,KENDALL,17093,29492,33168,62660,52.93329077561443,Biden
ILLINOIS,KNOX,17095,12009,10703,22712,47.12486791123635,Trump
ILLINOIS,LAKE,17097,123594,204032,327626,62.27588775005647,Biden
ILLINOIS,LASALLE,17099,30113,22442,52555,42.70193131005613,Trump
ILLINOIS,LAWRENCE,17101,4886,1419,6305,22.505947660586838,Trump
ILLINOIS,LEE,17103,9630,6407,16037,39.95136247427823,Trump
ILLINOIS,LIVINGSTON,17105,12208,4615,16823,27.432681448017593,Trump
ILLINOIS,LOGAN,17107,9136,3840,12976,29.59309494451295,Trump
ILLINOIS,MACON,17115,28589,19847,48436,40.97572053844248,Trump
ILLINOIS,MACOUPIN,17117,16153,7365,23518,31.316438472659243,Trump
ILLINOIS,MADISON,17119,76031,57836,133867,43.204075687062534,Trump
ILLINOIS,MARION,17121,12678,4524,17202,26.299267527031738,Trump
ILLINOIS,MARSHALL,17123,4197,2005,6202,32.32828119961303,Trump
ILLINOIS,MASON,17125,4654,1985,6639,29.89908118692574,Trump
ILLINOIS,MASSAC,17127,4997,1725,6722,25.662005355548946,Trump
ILLINOIS,MCDONOUGH,17109,7027,4992,12019,41.53423745735918,Trump
ILLINOIS,MCHENRY,17111,82260,78154,160414,48.72018651738626,Trump
ILLINOIS,MCLEAN,17113,40502,43933,84435,52.03174039201753,Biden
ILLINOIS,MENARD,17129,4764,2022,6786,29.79664014146773,Trump
ILLINOIS,MERCER,17131,5418,3280,8698,37.70981834904576,Trump
ILLINOIS,MONROE,17133,14142,6569,20711,31.717444836077448,Trump
ILLINOIS,MONTGOMERY,17135,9544,3905,13449,29.035616030931667,Trump
ILLINOIS,MORGAN,17137,9950,5076,15026,33.781445494476245,Trump
ILLINOIS,MOULTRIE,17139,4964,1662,6626,25.083006338665864,Trump
ILLINOIS,OGLE,17141,16248,9428,25676,36.71911512696682,Trump
ILLINOIS,PEORIA,17143,38252,43578,81830,53.254307711108396,Biden
ILLINOIS,PERRY,17145,7313,2612,9925,26.317380352644836,Trump
ILLINOIS,PIATT,17147,6248,3329,9577,34.760363370575334,Trump
ILLINOIS,PIKE,17149,6332,1484,7816,18.986693961105424,Trump
ILLINOIS,POPE,17151,1722,433,2155,20.092807424593968,Trump
ILLINOIS,PULASKI,17153,1699,891,2590,34.401544401544406,Trump
ILLINOIS,PUTNAM,17155,1993,1338,3331,40.16811768237766,Trump
ILLINOIS,RANDOLPH,17157,11076,3592,14668,24.488682847013905,Trump
ILLINOIS,RICHLAND,17159,6089,1830,7919,23.10897840636444,Trump
ILLINOIS,ROCK ISLAND,17161,28603,36691,65294,56.19352467301743,Biden
ILLINOIS,SALINE,17165,8103,2789,10892,25.605949320602278,Trump
ILLINOIS,SANGAMON,17167,53485,48917,102402,47.769574812991934,Trump
ILLINOIS,SCHUYLER,17169,2773,1068,3841,27.805259047123144,Trump
ILLINOIS,SCOTT,17171,2114,572,2686,21.295606850335073,Trump
ILLINOIS,SHELBY,17173,9426,2504,11930,20.98910310142498,Trump
ILLINOIS,ST. CLAIR,17163,57150,68325,125475,54.453078302450685,Biden
ILLINOIS,STARK,17175,2004,815,2819,28.910961333806313,Trump
ILLINOIS,STEPHENSON,17177,12521,9055,21576,41.96792732665925,Trump
ILLINOIS,TAZEWELL,17179,42513,24819,67332,36.86063090358225,Trump
ILLINOIS,UNION,17181,6161,2579,8740,29.508009153318078,Trump
ILLINOIS,VERMILION,17183,20725,10323,31048,33.24851842308683,Trump
ILLINOIS,WABASH,17185,4237,1253,5490,22.823315118397087,Trump
ILLINOIS,WARREN,17187,4676,3090,7766,39.78882307494205,Trump
ILLINOIS,WASHINGTON,17189,6115,1641,7756,21.157813305827748,Trump
ILLINOIS,WAYNE,17191,7176,1187,8363,14.193471242377138,Trump
ILLINOIS,WHITE,17193,5791,1517,7308,20.75807334428024,Trump
ILLINOIS,WHITESIDE,17195,14527,12253,26780,45.75429424943988,Trump
ILLINOIS,WILL,17197,155116,183915,339031,54.24725172624332,Biden
ILLINOIS,WILLIAMSON,17199,22801,10206,33007,30.920713787984365,Trump
ILLINOIS,WINNEBAGO,17201,60861,64056,124917,51.27884915583948,Biden
ILLINOIS,WOODFORD,17203,14799,6160,20959,29.39071520587814,Trump
INDIANA,ADAMS,18001,10686,3236,13922,23.24378681223962,Trump
INDIANA,ALLEN,18003,92083,73189,165272,44.283968246284914,Trump
INDIANA,BARTHOLOMEW,18005,22410,12934,35344,36.594612947034854,Trump
INDIANA,BENTON,18007,3007,1009,4016,25.124501992031874,Trump
INDIANA,BLACKFORD,18009,3841,1376,5217,26.375311481694457,Trump
INDIANA,BOONE,18011,22351,15244,37595,40.54794520547945,Trump
INDIANA,BROWN,18013,5777,3036,8813,34.44910927039601,Trump
INDIANA,CARROLL,18015,7086,2224,9310,23.888292158968852,Trump
INDIANA,CASS,18017,10552,4304,14856,28.971459343026385,Trump
INDIANA,CLARK,18019,33668,23093,56761,40.68462500660665,Trump
INDIANA,CLAY,18021,9499,2552,12051,21.17666583686001,Trump
INDIANA,CLINTON,18023,9334,3361,12695,26.474990153603784,Trump
INDIANA,CRAWFORD,18025,3483,1355,4838,28.007441091360064,Trump
INDIANA,DAVIESS,18027,9576,2169,11745,18.46743295019157,Trump
INDIANA,DEARBORN,18029,19528,5446,24974,21.806678946103947,Trump
INDIANA,DECATUR,18031,9575,2439,12014,20.301315132345596,Trump
INDIANA,DEKALB,18033,14237,4966,19203,25.860542623548405,Trump
INDIANA,DELAWARE,18035,26827,20474,47301,43.284497156508316,Trump
INDIANA,DUBOIS,18037,15033,6292,21325,29.505275498241502,Trump
INDIANA,ELKHART,18039,46972,26108,73080,35.72523262178435,Trump
INDIANA,FAYETTE,18041,7755,2237,9992,22.38791032826261,Trump
INDIANA,FLOYD,18043,23400,17511,40911,42.802669208770254,Trump
INDIANA,FOUNTAIN,18045,6154,1629,7783,20.930232558139537,Trump
INDIANA,FRANKLIN,18047,9691,2137,11828,18.067297937098413,Trump
INDIANA,FULTON,18049,6694,2280,8974,25.406730554936484,Trump
INDIANA,GIBSON,18051,11817,4023,15840,25.397727272727273,Trump
INDIANA,GRANT,18053,18543,8015,26558,30.179230363732206,Trump
INDIANA,GREENE,18055,11103,3389,14492,23.385316036433895,Trump
INDIANA,HAMILTON,18057,101587,88390,189977,46.52668480921375,Trump
INDIANA,HANCOCK,18059,28996,12895,41891,30.78226826764699,Trump
INDIANA,HARRISON,18061,14565,5343,19908,26.838456901748042,Trump
INDIANA,HENDRICKS,18063,53802,32604,86406,37.733490729810434,Trump
INDIANA,HENRY,18065,15043,5544,20587,26.92961577694662,Trump
INDIANA,HOWARD,18067,26449,13303,39752,33.46498289394244,Trump
INDIANA,HUNTINGTON,18069,13147,4255,17402,24.45121250430985,Trump
INDIANA,JACKSON,18071,14555,4302,18857,22.81380919552421,Trump
INDIANA,JASPER,18073,11383,3798,15181,25.018114748699034,Trump
INDIANA,JAY,18075,6361,1926,8287,23.241221189815374,Trump
INDIANA,JEFFERSON,18077,9663,4731,14394,32.867861609003754,Trump
INDIANA,JENNINGS,18079,9490,2523,12013,21.00224756513777,Trump
INDIANA,JOHNSON,18081,51219,24736,75955,32.56665130669475,Trump
INDIANA,KNOX,18083,11655,4067,15722,25.868210151380232,Trump
INDIANA,KOSCIUSKO,18085,26499,8364,34863,23.99105068410636,Trump
INDIANA,LAGRANGE,18087,8110,2355,10465,22.50358337314859,Trump
INDIANA,LAKE,18089,91760,124870,216630,57.6420625028851,Biden
INDIANA,LAPORTE,18091,25997,22427,48424,46.31381133322319,Trump
INDIANA,LAWRENCE,18093,15601,4961,20562,24.12703044450929,Trump
INDIANA,MADISON,18095,31215,19524,50739,38.47927629634009,Trump
INDIANA,MARION,18097,134175,247772,381947,64.87078050095955,Biden
INDIANA,MARSHALL,18099,13844,5712,19556,29.208427081202696,Trump
INDIANA,MARTIN,18101,4029,1011,5040,20.05952380952381,Trump
INDIANA,MIAMI,18103,10925,3235,14160,22.846045197740114,Trump
INDIANA,MONROE,18105,22071,39861,61932,64.36252664212361,Biden
INDIANA,MONTGOMERY,18107,12659,4213,16872,24.97036510194405,Trump
INDIANA,MORGAN,18109,27512,7781,35293,22.046864817385885,Trump
INDIANA,NEWTON,18111,4942,1509,6451,23.391722213610294,Trump
INDIANA,NOBLE,18113,14195,4660,18855,24.7149297268629,Trump
INDIANA,OHIO,18115,2054,668,2722,24.540778839088905,Trump
INDIANA,ORANGE,18117,6432,2224,8656,25.693160813308687,Trump
INDIANA,OWEN,18119,7286,2420,9706,24.93303111477437,Trump
INDIANA,PARKE,18121,5400,1503,6903,21.773142112125164,Trump
INDIANA,PERRY,18123,5345,3203,8548,37.47075339260646,Trump
INDIANA,PIKE,18125,4692,1415,6107,23.17013263468151,Trump
INDIANA,PORTER,18127,45008,39746,84754,46.895721735847275,Trump
INDIANA,POSEY,18129,9206,3811,13017,29.277099177998,Trump
INDIANA,PULASKI,18131,4246,1463,5709,25.626204238921,Trump
INDIANA,PUTNAM,18133,12278,3946,16224,24.32199211045365,Trump
INDIANA,RANDOLPH,18135,8312,2513,10825,23.214780600461893,Trump
INDIANA,RIPLEY,18137,11261,2774,14035,19.764873530459564,Trump
INDIANA,RUSH,18139,6035,1754,7789,22.51893696238285,Trump
INDIANA,SCOTT,18143,7331,2701,10032,26.923843700159487,Trump
INDIANA,SHELBY,18145,14568,5023,19591,25.63932417947016,Trump
INDIANA,SPENCER,18147,7357,3213,10570,30.39735099337748,Trump
INDIANA,ST. JOSEPH,18141,53164,59896,113060,52.97718025826994,Biden
INDIANA,STARKE,18149,7466,2650,10116,26.196124950573353,Trump
INDIANA,STEUBEN,18151,11327,4513,15840,28.491161616161616,Trump
INDIANA,SULLIVAN,18153,6691,2153,8844,24.3441881501583,Trump
INDIANA,SWITZERLAND,18155,3133,964,4097,23.52941176470588,Trump
INDIANA,TIPPECANOE,18157,34581,35017,69598,50.31322739159171,Biden
INDIANA,TIPTON,18159,6110,1834,7944,23.086606243705944,Trump
INDIANA,UNION,18161,2688,736,3424,21.49532710280374,Trump
INDIANA,VANDERBURGH,18163,41844,34415,76259,45.129099516122686,Trump
INDIANA,VERMILLION,18165,5184,2145,7329,29.267294310274256,Trump
INDIANA,VIGO,18167,24545,18123,42668,42.4744539233149,Trump
INDIANA,WABASH,18169,10762,3494,14256,24.508978675645345,Trump
INDIANA,WARREN,18171,3401,974,4375,22.262857142857143,Trump
INDIANA,WARRICK,18173,21326,11923,33249,35.859725104514425,Trump
INDIANA,WASHINGTON,18175,9114,2784,11898,23.398890569843672,Trump
INDIANA,WAYNE,18177,17567,9524,27091,35.15558672621904,Trump
INDIANA,WELLS,18179,10855,2928,13783,21.243560908365378,Trump
INDIANA,WHITE,18181,7957,3032,10989,27.59122759122759,Trump
INDIANA,WHITLEY,18183,12862,4234,17096,24.766027140851662,Trump
IOWA,ADAIR,19001,2922,1198,4120,29.07766990291262,Trump
IOWA,ADAMS,19003,1535,590,2125,27.764705882352942,Trump
IOWA,ALLAMAKEE,19005,4744,2576,7320,35.19125683060109,Trump
IOWA,APPANOOSE,19007,4522,1891,6413,29.486979572742868,Trump
IOWA,AUDUBON,19009,2299,1071,3370,31.780415430267063,Trump
IOWA,BENTON,19011,9208,5160,14368,35.91314031180401,Trump
IOWA,BLACK HAWK,19013,29813,35647,65460,54.456156431408495,Biden
IOWA,BOONE,19015,8729,6303,15032,41.930548163916974,Trump
IOWA,BREMER,19017,8324,5958,14282,41.71684638005881,Trump
IOWA,BUCHANAN,19019,6430,4169,10599,39.333899424474005,Trump
IOWA,BUENA VISTA,19021,5074,2961,8035,36.851275668948354,Trump
IOWA,BUTLER,19023,5556,2424,7980,30.37593984962406,Trump
IOWA,CALHOUN,19025,3698,1470,5168,28.444272445820435,Trump
IOWA,CARROLL,19027,7766,3454,11220,30.784313725490197,Trump
IOWA,CASS,19029,4979,2201,7180,30.654596100278553,Trump
IOWA,CEDAR,19031,6184,4337,10521,41.22231727022146,Trump
IOWA,CERRO GORDO,19033,12499,10941,23440,46.67662116040955,Trump
IOWA,CHEROKEE,19035,4510,1936,6446,30.034129692832767,Trump
IOWA,CHICKASAW,19037,4322,2233,6555,34.06559877955759,Trump
IOWA,CLARKE,19039,3153,1466,4619,31.73847153063434,Trump
IOWA,CLAY,19041,6158,2662,8820,30.18140589569161,Trump
IOWA,CLAYTON,19043,6119,3340,9459,35.31028649962998,Trump
IOWA,CLINTON,19045,13410,10812,24222,44.63710676244736,Trump
IOWA,CRAWFORD,19047,4862,2220,7082,31.347077096865295,Trump
IOWA,DALLAS,19049,28162,26879,55041,48.83450518704239,Trump
IOWA,DAVIS,19051,3035,1013,4048,25.024703557312257,Trump
IOWA,DECATUR,19053,2618,1120,3738,29.962546816479403,Trump
IOWA,DELAWARE,19055,6688,3157,9845,32.06703910614525,Trump
IOWA,DES MOINES,19057,10642,8893,19535,45.52341950345534,Trump
IOWA,DICKINSON,19059,7452,3661,11113,32.94339962206425,Trump
IOWA,DUBUQUE,19061,27358,25657,53015,48.39573705555031,Trump
IOWA,EMMET,19063,3268,1520,4788,31.746031746031743,Trump
IOWA,FAYETTE,19065,6174,3835,10009,38.31551603556799,Trump
IOWA,FLOYD,19067,4747,3172,7919,40.05556257103169,Trump
IOWA,FRANKLIN,19069,3433,1626,5059,32.14073927653687,Trump
IOWA,FREMONT,19071,2717,1080,3797,28.443508032657363,Trump
IOWA,GREENE,19073,3229,1769,4998,35.39415766306523,Trump
IOWA,GRUNDY,19075,4945,2206,7151,30.848832331142496,Trump
IOWA,GUTHRIE,19077,4280,1985,6265,31.683958499600955,Trump
IOWA,HAMILTON,19079,4982,2843,7825,36.33226837060703,Trump
IOWA,HANCOCK,19081,4401,1683,6084,27.662721893491128,Trump
IOWA,HARDIN,19083,5864,2976,8840,33.665158371040725,Trump
IOWA,HARRISON,19085,5580,2440,8020,30.423940149625935,Trump
IOWA,HENRY,19087,6525,3275,9800,33.41836734693878,Trump
IOWA,HOWARD,19089,3133,1772,4905,36.12640163098879,Trump
IOWA,HUMBOLDT,19091,3825,1442,5267,27.378014049743687,Trump
IOWA,IDA,19093,2885,917,3802,24.118884797475012,Trump
IOWA,IOWA,19095,6035,3547,9582,37.01732414944688,Trump
IOWA,JACKSON,19097,6957,4029,10986,36.67394866193337,Trump
IOWA,JASPER,19099,12125,7737,19862,38.95378108951767,Trump
IOWA,JEFFERSON,19101,4476,4319,8795,49.107447413303014,Trump
IOWA,JOHNSON,19103,23206,59177,82383,71.83156719226054,Biden
IOWA,JONES,19105,6596,4213,10809,38.97677861041725,Trump
IOWA,KEOKUK,19107,3809,1414,5223,27.07256366073138,Trump
IOWA,KOSSUTH,19109,6288,2696,8984,30.008904719501334,Trump
IOWA,LEE,19111,9808,6541,16349,40.00856321487552,Trump
IOWA,LINN,19113,53744,70874,124618,56.87300389991815,Biden
IOWA,LOUISA,19115,3506,1726,5232,32.989296636085626,Trump
IOWA,LUCAS,19117,3295,1284,4579,28.04105699934484,Trump
IOWA,LYON,19119,5718,1067,6785,15.725865880619013,Trump
IOWA,MADISON,19121,6525,3134,9659,32.446423025157884,Trump
IOWA,MAHASKA,19123,8320,2894,11214,25.807026930622435,Trump
IOWA,MARION,19125,12722,6178,18900,32.68783068783069,Trump
IOWA,MARSHALL,19127,9610,8176,17786,45.96873945800068,Trump
IOWA,MILLS,19129,5616,2508,8124,30.87149187592319,Trump
IOWA,MITCHELL,19131,3684,2053,5737,35.78525361687293,Trump
IOWA,MONONA,19133,3262,1407,4669,30.13493253373313,Trump
IOWA,MONROE,19135,2978,1078,4056,26.577909270216963,Trump
IOWA,MONTGOMERY,19137,3666,1583,5249,30.158125357210896,Trump
IOWA,MUSCATINE,19139,10865,9372,20237,46.31121213618619,Trump
IOWA,O'BRIEN,19141,5871,1569,7440,21.088709677419352,Trump
IOWA,OSCEOLA,19143,2695,601,3296,18.23422330097087,Trump
IOWA,PAGE,19145,5328,2086,7414,28.13595899649312,Trump
IOWA,PALO ALTO,19147,3378,1519,4897,31.018991219113744,Trump
IOWA,PLYMOUTH,19149,10515,3494,14009,24.941109286887002,Trump
IOWA,POCAHONTAS,19151,2832,933,3765,24.780876494023904,Trump
IOWA,POLK,19153,107564,146250,253814,57.62093501540498,Biden
IOWA,POTTAWATTAMIE,19155,26352,18575,44927,41.34484830947982,Trump
IOWA,POWESHIEK,19157,5673,4306,9979,43.150616294217855,Trump
IOWA,RINGGOLD,19159,1974,709,2683,26.425642937010807,Trump
IOWA,SAC,19161,4069,1389,5458,25.44888237449615,Trump
IOWA,SCOTT,19163,43958,46926,90884,51.63285066678404,Biden
IOWA,SHELBY,19165,4711,1959,6670,29.37031484257871,Trump
IOWA,SIOUX,19167,15775,3019,18794,16.063637331063106,Trump
IOWA,STORY,19169,20541,29175,49716,58.68332126478397,Biden
IOWA,TAMA,19171,5325,3577,8902,40.18198157717367,Trump
IOWA,TAYLOR,19173,2470,746,3216,23.196517412935325,Trump
IOWA,UNION,19175,4024,2061,6085,33.87017255546426,Trump
IOWA,VAN BUREN,19177,2870,875,3745,23.364485981308412,Trump
IOWA,WAPELLO,19179,9536,5821,15357,37.90453864687113,Trump
IOWA,WARREN,19181,17868,12574,30442,41.30477629590697,Trump
IOWA,WASHINGTON,19183,6991,4561,11552,39.48234072022161,Trump
IOWA,WAYNE,19185,2344,727,3071,23.673070661022468,Trump
IOWA,WEBSTER,19187,10970,6613,17583,37.610191662401185,Trump
IOWA,WINNEBAGO,19189,3726,2135,5861,36.42723084797816,Trump
IOWA,WINNESHIEK,19191,6263,5617,11880,47.28114478114478,Trump
IOWA,WOODBURY,19193,25926,18704,44630,41.90902980058257,Trump
IOWA,WORTH,19195,2742,1596,4338,36.7911479944675,Trump
IOWA,WRIGHT,19197,4148,1996,6144,32.48697916666667,Trump
KANSAS,ALLEN,20001,4218,1570,5788,27.12508638562543,Trump
KANSAS,ANDERSON,20003,2929,782,3711,21.072487200215576,Trump
KANSAS,ATCHISON,20005,4906,2359,7265,32.47075017205781,Trump
KANSAS,BARBER,20007,2014,291,2305,12.62472885032538,Trump
KANSAS,BARTON,20009,8608,2340,10948,21.373766898063572,Trump
KANSAS,BOURBON,20011,5023,1541,6564,23.476538695917124,Trump
KANSAS,BROWN,20013,3262,1104,4366,25.286303252404945,Trump
KANSAS,BUTLER,20015,22634,9181,31815,28.857457174288857,Trump
KANSAS,CHASE,20017,1123,345,1468,23.501362397820163,Trump
KANSAS,CHAUTAUQUA,20019,1402,212,1614,13.135068153655514,Trump
KANSAS,CHEROKEE,20021,6766,2194,8960,24.486607142857142,Trump
KANSAS,CHEYENNE,20023,1183,224,1407,15.92039800995025,Trump
KANSAS,CLARK,20025,904,143,1047,13.658070678127984,Trump
KANSAS,CLAY,20027,3177,894,4071,21.96020633750921,Trump
KANSAS,CLOUD,20029,3242,920,4162,22.10475732820759,Trump
KANSAS,COFFEY,20031,3489,964,4453,21.64832697058163,Trump
KANSAS,COMANCHE,20033,762,126,888,14.18918918918919,Trump
KANSAS,COWLEY,20035,9656,4273,13929,30.677004810108404,Trump
KANSAS,CRAWFORD,20037,10045,6179,16224,38.08555226824458,Trump
KANSAS,DECATUR,20039,1260,218,1478,14.749661705006767,Trump
KANSAS,DICKINSON,20041,7126,2060,9186,22.425430002177226,Trump
KANSAS,DONIPHAN,20043,2976,686,3662,18.732932823593664,Trump
KANSAS,DOUGLAS,20045,17286,40785,58071,70.23299064937748,Biden
KANSAS,EDWARDS,20047,1141,271,1412,19.192634560906516,Trump
KANSAS,ELK,20049,1140,195,1335,14.606741573033707,Trump
KANSAS,ELLIS,20051,9758,3737,13495,27.691737680622452,Trump
KANSAS,ELLSWORTH,20053,2148,648,2796,23.17596566523605,Trump
KANSAS,FINNEY,20055,7236,4325,11561,37.41025862814635,Trump
KANSAS,FORD,20057,5803,2947,8750,33.68,Trump
KANSAS,FRANKLIN,20059,8479,3690,12169,30.322951762675654,Trump
KANSAS,GEARY,20061,5323,3983,9306,42.80034386417365,Trump
KANSAS,GOVE,20063,1291,166,1457,11.393273850377488,Trump
KANSAS,GRAHAM,20065,1080,228,1308,17.431192660550458,Trump
KANSAS,GRANT,20067,1936,518,2454,21.10839445802771,Trump
KANSAS,GRAY,20069,1911,341,2252,15.142095914742452,Trump
KANSAS,GREELEY,20071,549,78,627,12.440191387559809,Trump
KANSAS,GREENWOOD,20073,2444,569,3013,18.884832392963823,Trump
KANSAS,HAMILTON,20075,698,141,839,16.805721096543504,Trump
KANSAS,HARPER,20077,2168,461,2629,17.535184480791173,Trump
KANSAS,HARVEY,20079,10182,6747,16929,39.85468722310828,Trump
KANSAS,HASKELL,20081,1122,268,1390,19.280575539568346,Trump
KANSAS,HODGEMAN,20083,875,154,1029,14.965986394557824,Trump
KANSAS,JACKSON,20085,4517,1881,6398,29.399812441387933,Trump
KANSAS,JEFFERSON,20087,6334,3194,9528,33.52225020990764,Trump
KANSAS,JEWELL,20089,1387,212,1599,13.258286429018137,Trump
KANSAS,JOHNSON,20091,155631,184259,339890,54.21136249963223,Biden
KANSAS,KEARNY,20093,1164,267,1431,18.658280922431867,Trump
KANSAS,KINGMAN,20095,3130,752,3882,19.371458011334365,Trump
KANSAS,KIOWA,20097,980,156,1136,13.732394366197184,Trump
KANSAS,LABETTE,20099,5735,2655,8390,31.64481525625745,Trump
KANSAS,LANE,20101,762,115,877,13.112884834663626,Trump
KANSAS,LEAVENWORTH,20103,21610,13886,35496,39.11990083389678,Trump
KANSAS,LINCOLN,20105,1283,266,1549,17.172369270497096,Trump
KANSAS,LINN,20107,4048,896,4944,18.12297734627832,Trump
KANSAS,LOGAN,20109,1249,186,1435,12.961672473867598,Trump
KANSAS,LYON,20111,7550,6055,13605,44.50569643513414,Trump
KANSAS,MARION,20115,4465,1516,5981,25.346931951178732,Trump
KANSAS,MARSHALL,20117,3729,1259,4988,25.240577385725743,Trump
KANSAS,MCPHERSON,20113,9964,4134,14098,29.32330827067669,Trump
KANSAS,MEADE,20119,1523,263,1786,14.725643896976484,Trump
KANSAS,MIAMI,20121,12308,5247,17555,29.888920535459985,Trump
KANSAS,MITCHELL,20123,2504,558,3062,18.22338340953625,Trump
KANSAS,MONTGOMERY,20125,9931,3228,13159,24.530739417888896,Trump
KANSAS,MORRIS,20127,2124,729,2853,25.55205047318612,Trump
KANSAS,MORTON,20129,1034,150,1184,12.66891891891892,Trump
KANSAS,NEMAHA,20131,4664,927,5591,16.58021820783402,Trump
KANSAS,NEOSHO,20133,4970,1796,6766,26.544487141590306,Trump
KANSAS,NESS,20135,1339,149,1488,10.013440860215054,Trump
KANSAS,NORTON,20137,2007,364,2371,15.352172079291437,Trump
KANSAS,OSAGE,20139,5705,2136,7841,27.24142328784594,Trump
KANSAS,OSBORNE,20141,1629,281,1910,14.712041884816754,Trump
KANSAS,OTTAWA,20143,2610,506,3116,16.238767650834404,Trump
KANSAS,PAWNEE,20145,2045,643,2688,23.921130952380953,Trump
KANSAS,PHILLIPS,20147,2418,318,2736,11.62280701754386,Trump
KANSAS,POTTAWATOMIE,20149,9452,3313,12765,25.953779866823346,Trump
KANSAS,PRATT,20151,3108,933,4041,23.088344469190794,Trump
KANSAS,RAWLINS,20153,1261,214,1475,14.508474576271185,Trump
KANSAS,RENO,20155,18443,8886,27329,32.51491090050862,Trump
KANSAS,REPUBLIC,20157,2182,424,2606,16.270145817344588,Trump
KANSAS,RICE,20159,3262,965,4227,22.829429855689614,Trump
KANSAS,RILEY,20161,11610,12765,24375,52.36923076923077,Biden
KANSAS,ROOKS,20163,2325,339,2664,12.725225225225225,Trump
KANSAS,RUSH,20165,1350,295,1645,17.933130699088146,Trump
KANSAS,RUSSELL,20167,2790,600,3390,17.699115044247787,Trump
KANSAS,SALINE,20169,15722,8214,23936,34.31651069518716,Trump
KANSAS,SCOTT,20171,2014,299,2313,12.926934716817987,Trump
KANSAS,SEDGWICK,20173,122416,95870,218286,43.91944513161632,Trump
KANSAS,SEWARD,20175,3372,1833,5205,35.21613832853026,Trump
KANSAS,SHAWNEE,20177,40443,43015,83458,51.54089482134726,Biden
KANSAS,SHERIDAN,20179,1282,147,1429,10.286913925822255,Trump
KANSAS,SHERMAN,20181,2269,396,2665,14.859287054409007,Trump
KANSAS,SMITH,20183,1763,336,2099,16.00762267746546,Trump
KANSAS,STAFFORD,20185,1645,357,2002,17.832167832167833,Trump
KANSAS,STANTON,20187,614,148,762,19.42257217847769,Trump
KANSAS,STEVENS,20189,1760,237,1997,11.86780170255383,Trump
KANSAS,SUMNER,20191,8105,2591,10696,24.224008975317876,Trump
KANSAS,THOMAS,20193,3130,625,3755,16.644474034620508,Trump
KANSAS,TREGO,20195,1363,242,1605,15.077881619937694,Trump
KANSAS,WABAUNSEE,20197,2845,964,3809,25.308479915988446,Trump
KANSAS,WALLACE,20199,770,44,814,5.405405405405405,Trump
KANSAS,WASHINGTON,20201,2363,475,2838,16.737138830162085,Trump
KANSAS,WICHITA,20203,808,149,957,15.569487983281086,Trump
KANSAS,WILSON,20205,3153,723,3876,18.653250773993808,Trump
KANSAS,WOODSON,20207,1228,294,1522,19.316688567674113,Trump
KANSAS,WYANDOTTE,20209,18934,36788,55722,66.02060227558235,Biden
KENTUCKY,ADAIR,21001,7276,1392,8668,16.059067835717585,Trump
KENTUCKY,ALLEN,21003,7586,1642,9228,17.793671434763763,Trump
KENTUCKY,ANDERSON,21005,9657,3347,13004,25.73823438941864,Trump
KENTUCKY,BALLARD,21007,3356,825,4181,19.732121502033007,Trump
KENTUCKY,BARREN,21009,14654,5127,19781,25.91881098023356,Trump
KENTUCKY,BATH,21011,3986,1573,5559,28.29645619715776,Trump
KENTUCKY,BELL,21013,8140,1789,9929,18.01792728371437,Trump
KENTUCKY,BOONE,21015,44811,20897,65708,31.80282461800694,Trump
KENTUCKY,BOURBON,21017,6190,3296,9486,34.74594138730761,Trump
KENTUCKY,BOYD,21019,14295,7083,21378,33.132191973056415,Trump
KENTUCKY,BOYLE,21021,8872,5298,14170,37.38884968242767,Trump
KENTUCKY,BRACKEN,21023,3398,800,4198,19.05669366364936,Trump
KENTUCKY,BREATHITT,21025,4265,1301,5566,23.37405677326626,Trump
KENTUCKY,BRECKINRIDGE,21027,7701,2350,10051,23.380758133519052,Trump
KENTUCKY,BULLITT,21029,30708,10551,41259,25.57260234130735,Trump
KENTUCKY,BUTLER,21031,4960,1079,6039,17.867196555721147,Trump
KENTUCKY,CALDWELL,21033,4906,1433,6339,22.606089288531315,Trump
KENTUCKY,CALLOWAY,21035,11351,5794,17145,33.794109069699616,Trump
KENTUCKY,CAMPBELL,21037,28482,19373,47855,40.48270818096333,Trump
KENTUCKY,CARLISLE,21039,2159,463,2622,17.658276125095345,Trump
KENTUCKY,CARROLL,21041,2954,1116,4070,27.420147420147423,Trump
KENTUCKY,CARTER,21043,8775,2642,11417,23.140930191819216,Trump
KENTUCKY,CASEY,21045,6179,918,7097,12.935042975905311,Trump
KENTUCKY,CHRISTIAN,21047,15080,8296,23376,35.48939082819986,Trump
KENTUCKY,CLARK,21049,11811,6004,17815,33.701936570305925,Trump
KENTUCKY,CLAY,21051,6677,831,7508,11.068193926478424,Trump
KENTUCKY,CLINTON,21053,4280,603,4883,12.348965799713291,Trump
KENTUCKY,CRITTENDEN,21055,3451,731,4182,17.479674796747968,Trump
KENTUCKY,CUMBERLAND,21057,2769,508,3277,15.50198352151358,Trump
KENTUCKY,DAVIESS,21059,31023,17283,48306,35.77816420320457,Trump
KENTUCKY,EDMONSON,21061,4828,1227,6055,20.264244426094137,Trump
KENTUCKY,ELLIOTT,21063,2246,712,2958,24.07031778228533,Trump
KENTUCKY,ESTILL,21065,5100,1355,6455,20.99147947327653,Trump
KENTUCKY,FAYETTE,21067,58845,90566,149411,60.61534960612003,Biden
KENTUCKY,FLEMING,21069,5534,1474,7008,21.03310502283105,Trump
KENTUCKY,FLOYD,21071,12250,3884,16134,24.073385397297635,Trump
KENTUCKY,FRANKLIN,21073,12900,12650,25550,49.510763209393346,Trump
KENTUCKY,FULTON,21075,1605,791,2396,33.01335559265443,Trump
KENTUCKY,GALLATIN,21077,2955,822,3777,21.76330420969023,Trump
KENTUCKY,GARRARD,21079,6754,1830,8584,21.318732525629077,Trump
KENTUCKY,GRANT,21081,8725,2205,10930,20.173833485818847,Trump
KENTUCKY,GRAVES,21083,13206,3559,16765,21.22875037280048,Trump
KENTUCKY,GRAYSON,21085,9453,2400,11853,20.248038471273095,Trump
KENTUCKY,GREEN,21087,4838,920,5758,15.977770059048279,Trump
KENTUCKY,GREENUP,21089,13064,4873,17937,27.167307799520547,Trump
KENTUCKY,HANCOCK,21091,3145,1351,4496,30.048932384341636,Trump
KENTUCKY,HARDIN,21093,29832,18101,47933,37.763127699079966,Trump
KENTUCKY,HARLAN,21095,9367,1494,10861,13.755639443881778,Trump
KENTUCKY,HARRISON,21097,6334,2400,8734,27.478818410808337,Trump
KENTUCKY,HART,21099,6345,1908,8253,23.11886586695747,Trump
KENTUCKY,HENDERSON,21101,12730,7639,20369,37.503068388237025,Trump
KENTUCKY,HENRY,21103,5843,2142,7985,26.825297432686284,Trump
KENTUCKY,HICKMAN,21105,1714,458,2172,21.086556169429098,Trump
KENTUCKY,HOPKINS,21107,15757,5439,21196,25.660501981505945,Trump
KENTUCKY,JACKSON,21109,5453,605,6058,9.986794321558271,Trump
KENTUCKY,JEFFERSON,21111,150619,228288,378907,60.24908486779078,Biden
KENTUCKY,JESSAMINE,21113,17096,8567,25663,33.38269103378405,Trump
KENTUCKY,JOHNSON,21115,8450,1608,10058,15.987273811891031,Trump
KENTUCKY,KENTON,21117,48123,32265,80388,40.13658755038065,Trump
KENTUCKY,KNOTT,21119,4779,1412,6191,22.807300920691326,Trump
KENTUCKY,KNOX,21121,11012,2114,13126,16.105439585555388,Trump
KENTUCKY,LARUE,21123,5685,1504,7189,20.920851300598137,Trump
KENTUCKY,LAUREL,21125,23234,4474,27708,16.146961166450122,Trump
KENTUCKY,LAWRENCE,21127,5633,1238,6871,18.017755785184107,Trump
KENTUCKY,LEE,21129,2159,459,2618,17.532467532467532,Trump
KENTUCKY,LESLIE,21131,4321,446,4767,9.35598909167191,Trump
KENTUCKY,LETCHER,21133,7226,1799,9025,19.933518005540165,Trump
KENTUCKY,LEWIS,21135,4986,823,5809,14.167670855568945,Trump
KENTUCKY,LINCOLN,21137,8489,2254,10743,20.981103974681186,Trump
KENTUCKY,LIVINGSTON,21139,4010,939,4949,18.973530006061832,Trump
KENTUCKY,LOGAN,21141,9067,3094,12161,25.44198667872708,Trump
KENTUCKY,LYON,21143,3100,1092,4192,26.049618320610683,Trump
KENTUCKY,MADISON,21151,27353,15580,42933,36.28910162345981,Trump
KENTUCKY,MAGOFFIN,21153,4174,1213,5387,22.517170967143123,Trump
KENTUCKY,MARION,21155,6113,2722,8835,30.80928126768534,Trump
KENTUCKY,MARSHALL,21157,13297,4071,17368,23.439659143251955,Trump
KENTUCKY,MARTIN,21159,3496,403,3899,10.335983585534752,Trump
KENTUCKY,MASON,21161,5477,2362,7839,30.131394310498788,Trump
KENTUCKY,MCCRACKEN,21145,21820,11190,33010,33.89881853983641,Trump
KENTUCKY,MCCREARY,21147,5664,725,6389,11.347628736891533,Trump
KENTUCKY,MCLEAN,21149,3633,1074,4707,22.817080943275972,Trump
KENTUCKY,MEADE,21163,10184,3632,13816,26.288361320208452,Trump
KENTUCKY,MENIFEE,21165,2311,750,3061,24.501796798431887,Trump
KENTUCKY,MERCER,21167,8506,3033,11539,26.28477337724239,Trump
KENTUCKY,METCALFE,21169,3959,975,4934,19.760843129306853,Trump
KENTUCKY,MONROE,21171,4628,657,5285,12.431409649952696,Trump
KENTUCKY,MONTGOMERY,21173,8993,3630,12623,28.757030816763052,Trump
KENTUCKY,MORGAN,21175,4297,1172,5469,21.429877491314684,Trump
KENTUCKY,MUHLENBERG,21177,10496,3544,14040,25.242165242165242,Trump
KENTUCKY,NELSON,21179,15703,7188,22891,31.40098728758027,Trump
KENTUCKY,NICHOLAS,21181,2408,955,3363,28.397264347308948,Trump
KENTUCKY,OHIO,21183,8582,2404,10986,21.882395776442745,Trump
KENTUCKY,OLDHAM,21185,22651,14504,37155,39.03646884672319,Trump
KENTUCKY,OWEN,21187,4292,1098,5390,20.371057513914657,Trump
KENTUCKY,OWSLEY,21189,1670,216,1886,11.452810180275716,Trump
KENTUCKY,PENDLETON,21191,5515,1322,6837,19.335966066988444,Trump
KENTUCKY,PERRY,21193,8118,2350,10468,22.449369507069164,Trump
KENTUCKY,PIKE,21195,20279,4862,25141,19.33892844357822,Trump
KENTUCKY,POWELL,21197,4041,1367,5408,25.277366863905325,Trump
KENTUCKY,PULASKI,21199,25441,5664,31105,18.2092911107539,Trump
KENTUCKY,ROBERTSON,21201,884,253,1137,22.251539138082673,Trump
KENTUCKY,ROCKCASTLE,21203,6577,1134,7711,14.70626377901699,Trump
KENTUCKY,ROWAN,21205,5994,3880,9874,39.29511849301195,Trump
KENTUCKY,RUSSELL,21207,7506,1329,8835,15.042444821731749,Trump
KENTUCKY,SCOTT,21209,17764,10564,28328,37.291725501270825,Trump
KENTUCKY,SHELBY,21211,15054,8076,23130,34.91569390402075,Trump
KENTUCKY,SIMPSON,21213,5888,2681,8569,31.287198039444508,Trump
KENTUCKY,SPENCER,21215,8737,2530,11267,22.454956953936275,Trump
KENTUCKY,TAYLOR,21217,9376,2961,12337,24.00097268379671,Trump
KENTUCKY,TODD,21219,4060,1202,5262,22.84302546560243,Trump
KENTUCKY,TRIGG,21221,5487,1791,7278,24.60840890354493,Trump
KENTUCKY,TRIMBLE,21223,3227,1012,4239,23.87355508374617,Trump
KENTUCKY,UNION,21225,4965,1529,6494,23.54481059439483,Trump
KENTUCKY,WARREN,21227,31790,22477,54267,41.41927875135902,Trump
KENTUCKY,WASHINGTON,21229,4482,1644,6126,26.83643486777669,Trump
KENTUCKY,WAYNE,21231,7430,1700,9130,18.619934282584886,Trump
KENTUCKY,WEBSTER,21233,4506,1412,5918,23.859411963501184,Trump
KENTUCKY,WHITLEY,21235,12567,2552,15119,16.879423242277927,Trump
KENTUCKY,WOLFE,21237,2097,839,2936,28.576294277929154,Trump
KENTUCKY,WOODFORD,21239,8362,6530,14892,43.849046467902234,Trump
LOUISIANA,ACADIA,22001,22596,5443,28039,19.41224722707657,Trump
LOUISIANA,ALLEN,22003,7574,2108,9682,21.77236108242099,Trump
LOUISIANA,ASCENSION,22005,40687,20399,61086,33.39390367678355,Trump
LOUISIANA,ASSUMPTION,22007,7271,3833,11104,34.51909221902017,Trump
LOUISIANA,AVOYELLES,22009,12028,4979,17007,29.276180396307407,Trump
LOUISIANA,BEAUREGARD,22011,13575,2542,16117,15.772166035862753,Trump
LOUISIANA,BIENVILLE,22013,3891,3067,6958,44.07875826386893,Trump
LOUISIANA,BOSSIER,22015,38074,15662,53736,29.146196218549946,Trump
LOUISIANA,CADDO,22017,48021,55110,103131,53.43689094452686,Biden
LOUISIANA,CALCASIEU,22019,55066,25982,81048,32.05754614549402,Trump
LOUISIANA,CALDWELL,22021,3976,745,4721,15.780554967167973,Trump
LOUISIANA,CAMERON,22023,3671,324,3995,8.110137672090113,Trump
LOUISIANA,CATAHOULA,22025,3541,1269,4810,26.38253638253638,Trump
LOUISIANA,CLAIBORNE,22027,3770,2731,6501,42.00892170435318,Trump
LOUISIANA,CONCORDIA,22029,5550,3177,8727,36.40426263320729,Trump
LOUISIANA,DE SOTO,22031,9112,5457,14569,37.45624270711785,Trump
LOUISIANA,EAST BATON ROUGE,22033,88420,115577,203997,56.656225336647104,Biden
LOUISIANA,EAST CARROLL,22035,1080,1900,2980,63.758389261744966,Biden
LOUISIANA,EAST FELICIANA,22037,6064,4280,10344,41.37664346481052,Trump
LOUISIANA,EVANGELINE,22039,11053,4158,15211,27.33548090197883,Trump
LOUISIANA,FRANKLIN,22041,6970,2658,9628,27.60697964270877,Trump
LOUISIANA,GRANT,22043,8117,1157,9274,12.475738624110416,Trump
LOUISIANA,IBERIA,22045,21251,11027,32278,34.162587520912076,Trump
LOUISIANA,IBERVILLE,22047,7893,8514,16407,51.89248491497531,Biden
LOUISIANA,JACKSON,22049,5394,2143,7537,28.433063553137856,Trump
LOUISIANA,JEFFERSON,22051,105949,84477,190426,44.362114417148916,Trump
LOUISIANA,JEFFERSON DAVIS,22053,11423,3208,14631,21.926047433531544,Trump
LOUISIANA,LA SALLE,22059,6378,638,7016,9.093500570125428,Trump
LOUISIANA,LAFAYETTE,22055,72519,39685,112204,35.36861430965028,Trump
LOUISIANA,LAFOURCHE,22057,36024,8672,44696,19.402183640594238,Trump
LOUISIANA,LINCOLN,22061,11311,7559,18870,40.05829358770535,Trump
LOUISIANA,LIVINGSTON,22063,54877,9249,64126,14.42316689018495,Trump
LOUISIANA,MADISON,22065,1930,2654,4584,57.89703315881326,Biden
LOUISIANA,MOREHOUSE,22067,6510,4946,11456,43.173882681564244,Trump
LOUISIANA,NATCHITOCHES,22069,9358,6896,16254,42.42647963578196,Trump
LOUISIANA,ORLEANS,22071,26664,147854,174518,84.72134679517299,Biden
LOUISIANA,OUACHITA,22073,42255,25913,68168,38.0134373899777,Trump
LOUISIANA,PLAQUEMINES,22075,7412,3414,10826,31.53519305375947,Trump
LOUISIANA,POINTE COUPEE,22077,7503,4683,12186,38.42934515017233,Trump
LOUISIANA,RAPIDES,22079,38347,19475,57822,33.680951886825085,Trump
LOUISIANA,RED RIVER,22081,2413,1644,4057,40.522553611042646,Trump
LOUISIANA,RICHLAND,22083,6607,3225,9832,32.801057770545164,Trump
LOUISIANA,SABINE,22085,8776,1731,10507,16.474731131626534,Trump
LOUISIANA,ST. BERNARD,22087,11179,6151,17330,35.4933641084824,Trump
LOUISIANA,ST. CHARLES,22089,18233,9800,28033,34.958798558841366,Trump
LOUISIANA,ST. HELENA,22091,2714,3346,6060,55.21452145214521,Biden
LOUISIANA,ST. JAMES,22093,5954,6510,12464,52.230423620025675,Biden
LOUISIANA,ST. JOHN THE BAPTIST,22095,7538,13582,21120,64.30871212121212,Biden
LOUISIANA,ST. LANDRY,22097,23171,17372,40543,42.84833386774536,Trump
LOUISIANA,ST. MARTIN,22099,18203,8439,26642,31.67554988364237,Trump
LOUISIANA,ST. MARY,22101,14811,8055,22866,35.2269745473629,Trump
LOUISIANA,ST. TAMMANY,22103,99666,37746,137412,27.469216662300234,Trump
LOUISIANA,TANGIPAHOA,22105,37806,18887,56693,33.31451854726333,Trump
LOUISIANA,TENSAS,22107,1197,1329,2526,52.612826603325416,Biden
LOUISIANA,TERREBONNE,22109,34339,11198,45537,24.590991940619716,Trump
LOUISIANA,UNION,22111,8407,2654,11061,23.994213904710243,Trump
LOUISIANA,VERMILION,22113,21930,5009,26939,18.59386020268013,Trump
LOUISIANA,VERNON,22115,14107,2898,17005,17.042046456924435,Trump
LOUISIANA,WASHINGTON,22117,13307,5970,19277,30.96954920371427,Trump
LOUISIANA,WEBSTER,22119,11830,6172,18002,34.285079435618265,Trump
LOUISIANA,WEST BATON ROUGE,22121,7684,6200,13884,44.65571881302218,Trump
LOUISIANA,WEST CARROLL,22123,4317,710,5027,14.123731848020688,Trump
LOUISIANA,WEST FELICIANA,22125,3863,2298,6161,37.29913975004058,Trump
LOUISIANA,WINN,22127,4619,1543,6162,25.04057124310289,Trump
MAINE,ANDROSCOGGIN,23001,29268,27617,56885,48.54882657994199,Trump
MAINE,AROOSTOOK,23003,21080,13956,35036,39.833314305285995,Trump
MAINE,CUMBERLAND,23005,59584,128759,188343,68.36410166557823,Biden
MAINE,FRANKLIN,23007,8754,8069,16823,47.96409677227605,Trump
MAINE,HANCOCK,23009,14982,19369,34351,56.38554918342989,Biden
MAINE,KENNEBEC,23011,34721,34902,69623,50.12998578056103,Biden
MAINE,KNOX,23013,9982,15110,25092,60.21839630161008,Biden
MAINE,LINCOLN,23015,10256,12684,22940,55.292066259808195,Biden
MAINE,OXFORD,23017,17698,14755,32453,45.46575046991033,Trump
MAINE,PENOBSCOT,23019,44825,37713,82538,45.691681407351766,Trump
MAINE,PISCATAQUIS,23021,6143,3517,9660,36.40786749482402,Trump
MAINE,SAGADAHOC,23023,9755,13528,23283,58.10247820298071,Biden
MAINE,SOMERSET,23025,16644,10199,26843,37.99500800953693,Trump
MAINE,WALDO,23027,11196,12345,23541,52.44042309162737,Biden
MAINE,WASHINGTON,23029,10194,6761,16955,39.87614273075789,Trump
MAINE,YORK,23031,54817,71189,126006,56.496516038918784,Biden
MARYLAND,ALLEGANY,24001,20886,9158,30044,30.481959792304618,Trump
MARYLAND,ANNE ARUNDEL,24003,127821,172823,300644,57.48426710661114,Biden
MARYLAND,BALTIMORE,24005,146202,258409,404611,63.86603428972519,Biden
MARYLAND,BALTIMORE CITY,24510,25374,207260,232634,89.09273794888108,Biden
MARYLAND,CALVERT,24009,25346,22587,47933,47.12202449252081,Trump
MARYLAND,CAROLINE,24011,10283,5095,15378,33.131746651059956,Trump
MARYLAND,CARROLL,24013,60218,36456,96674,37.71024267124563,Trump
MARYLAND,CECIL,24015,29439,16809,46248,36.345355474831344,Trump
MARYLAND,CHARLES,24017,25579,62171,87750,70.85014245014246,Biden
MARYLAND,DORCHESTER,24019,8764,6857,15621,43.89603738557071,Trump
MARYLAND,FREDERICK,24021,63682,77675,141357,54.94952496162199,Biden
MARYLAND,GARRETT,24023,12002,3281,15283,21.46829810901001,Trump
MARYLAND,HARFORD,24025,80930,63095,144025,43.80836660302031,Trump
MARYLAND,HOWARD,24027,48390,129433,177823,72.78754716768921,Biden
MARYLAND,KENT,24029,5195,5329,10524,50.63664006081338,Biden
MARYLAND,MONTGOMERY,24031,101222,419569,520791,80.5637962253572,Biden
MARYLAND,PRINCE GEORGE'S,24033,37090,379208,416298,91.09051688934369,Biden
MARYLAND,QUEEN ANNE'S,24035,18741,10709,29450,36.36332767402377,Trump
MARYLAND,SOMERSET,24039,5739,4241,9980,42.49498997995992,Trump
MARYLAND,ST MARY'S,24037,30826,23138,53964,42.87673263657253,Trump
MARYLAND,TALBOT,24041,10946,11062,22008,50.2635405307161,Biden
MARYLAND,WASHINGTON,24043,40224,26044,66268,39.30102010019919,Trump
MARYLAND,WICOMICO,24045,22944,22054,44998,49.01106715854038,Trump
MARYLAND,WORCESTER,24047,18571,12560,31131,40.34563618258328,Trump
MASSACHUSETTS,BARNSTABLE,25001,55311,91994,147305,62.451376395913236,Biden
MASSACHUSETTS,BERKSHIRE,25003,18064,51705,69769,74.10884490246384,Biden
MASSACHUSETTS,BRISTOL,25005,119872,153377,273249,56.130855007703595,Biden
MASSACHUSETTS,DUKES,25007,2631,9914,12545,79.02750099641291,Biden
MASSACHUSETTS,ESSEX,25009,144837,267198,412035,64.84837453128982,Biden
MASSACHUSETTS,FRANKLIN,25011,11201,30030,41231,72.83354757342777,Biden
MASSACHUSETTS,HAMPDEN,25013,87318,125948,213266,59.05676479138728,Biden
MASSACHUSETTS,HAMPSHIRE,25015,22281,63362,85643,73.98386324626648,Biden
MASSACHUSETTS,MIDDLESEX,25017,226956,617196,844152,73.11432064367554,Biden
MASSACHUSETTS,NANTUCKET,25019,1914,5241,7155,73.24947589098532,Biden
MASSACHUSETTS,NORFOLK,25021,125294,273312,398606,68.56695584110626,Biden
MASSACHUSETTS,PLYMOUTH,25023,121227,173630,294857,58.886171940974776,Biden
MASSACHUSETTS,SUFFOLK,25025,58613,270522,329135,82.19180579397512,Biden
MASSACHUSETTS,WORCESTER,25027,171683,248773,420456,59.16742774511483,Biden
MICHIGAN,ALCONA,26001,4848,2142,6990,30.643776824034337,Trump
MICHIGAN,ALGER,26003,3014,2053,5067,40.517071245312806,Trump
MICHIGAN,ALLEGAN,26005,41392,24449,65841,37.13339712337297,Trump
MICHIGAN,ALPENA,26007,10686,6000,16686,35.958288385472855,Trump
MICHIGAN,ANTRIM,26009,9748,5960,15708,37.94244970715559,Trump
MICHIGAN,ARENAC,26011,5928,2774,8702,31.877729257641924,Trump
MICHIGAN,BARAGA,26013,2512,1478,3990,37.042606516290725,Trump
MICHIGAN,BARRY,26015,23471,11797,35268,33.44958602699331,Trump
MICHIGAN,BAY,26017,33125,26151,59276,44.11734934880896,Trump
MICHIGAN,BENZIE,26019,6601,5480,12081,45.360483403691745,Trump
MICHIGAN,BERRIEN,26021,43519,37438,80957,46.24430253097323,Trump
MICHIGAN,BRANCH,26023,14064,6159,20223,30.455422044207094,Trump
MICHIGAN,CALHOUN,26025,36221,28877,65098,44.35927371040585,Trump
MICHIGAN,CASS,26027,16699,9130,25829,35.34786480312827,Trump
MICHIGAN,CHARLEVOIX,26029,9841,6939,16780,41.35280095351609,Trump
MICHIGAN,CHEBOYGAN,26031,10186,5437,15623,34.80125456058376,Trump
MICHIGAN,CHIPPEWA,26033,10681,6648,17329,38.36343701309943,Trump
MICHIGAN,CLARE,26035,10861,5199,16060,32.37235367372354,Trump
MICHIGAN,CLINTON,26037,25098,21968,47066,46.674882080482725,Trump
MICHIGAN,CRAWFORD,26039,5087,2672,7759,34.43742750354427,Trump
MICHIGAN,DELTA,26041,13207,7606,20813,36.544467400182576,Trump
MICHIGAN,DICKINSON,26043,9617,4744,14361,33.0339112875148,Trump
MICHIGAN,EATON,26045,31798,31299,63097,49.60457707973438,Trump
MICHIGAN,EMMET,26047,12135,9662,21797,44.327200990962055,Trump
MICHIGAN,GENESEE,26049,98714,119390,218104,54.73994057880645,Biden
MICHIGAN,GLADWIN,26051,9893,4524,14417,31.379621280432822,Trump
MICHIGAN,GOGEBIC,26053,4600,3570,8170,43.696450428396574,Trump
MICHIGAN,GRAND TRAVERSE,26055,30502,28683,59185,48.463293064120975,Trump
MICHIGAN,GRATIOT,26057,12102,6693,18795,35.61053471667997,Trump
MICHIGAN,HILLSDALE,26059,17037,5883,22920,25.667539267015705,Trump
MICHIGAN,HOUGHTON,26061,10378,7750,18128,42.75154457193292,Trump
MICHIGAN,HURON,26063,12731,5490,18221,30.130069699796934,Trump
MICHIGAN,INGHAM,26065,47639,94212,141851,66.41616907882214,Biden
MICHIGAN,IONIA,26067,20657,10901,31558,34.5427466886368,Trump
MICHIGAN,IOSCO,26069,9759,5373,15132,35.50753370340999,Trump
MICHIGAN,IRON,26071,4216,2493,6709,37.159040095394246,Trump
MICHIGAN,ISABELLA,26073,14815,14072,28887,48.713954373939835,Trump
MICHIGAN,JACKSON,26075,47372,31995,79367,40.31272443206874,Trump
MICHIGAN,KALAMAZOO,26077,56823,83686,140509,59.55917414542841,Biden
MICHIGAN,KALKASKA,26079,7436,3002,10438,28.760298907836752,Trump
MICHIGAN,KENT,26081,165741,187915,353656,53.13496731286901,Biden
MICHIGAN,KEWEENAW,26083,862,672,1534,43.807040417209905,Trump
MICHIGAN,LAKE,26085,3946,2288,6234,36.70195700994546,Trump
MICHIGAN,LAPEER,26087,35482,16367,51849,31.566664737989157,Trump
MICHIGAN,LEELANAU,26089,7916,8795,16711,52.63000418885764,Biden
MICHIGAN,LENAWEE,26091,31541,20918,52459,39.87494996092186,Trump
MICHIGAN,LIVINGSTON,26093,76982,48220,125202,38.51376176099423,Trump
MICHIGAN,LUCE,26095,2109,842,2951,28.532700779396812,Trump
MICHIGAN,MACKINAC,26097,4304,2632,6936,37.94694348327566,Trump
MICHIGAN,MACOMB,26099,263863,223952,487815,45.90920738394678,Trump
MICHIGAN,MANISTEE,26101,8321,6107,14428,42.32741890767951,Trump
MICHIGAN,MARQUETTE,26103,16286,20465,36751,55.68555957661015,Biden
MICHIGAN,MASON,26105,10207,6802,17009,39.990593215356576,Trump
MICHIGAN,MECOSTA,26107,13267,7375,20642,35.72812711946517,Trump
MICHIGAN,MENOMINEE,26109,8117,4316,12433,34.71406740127081,Trump
MICHIGAN,MIDLAND,26111,27675,20493,48168,42.544843049327355,Trump
MICHIGAN,MISSAUKEE,26113,6648,1967,8615,22.832269297736506,Trump
MICHIGAN,MONROE,26115,52710,32975,85685,38.483982027192624,Trump
MICHIGAN,MONTCALM,26117,21815,9703,31518,30.785582841550863,Trump
MICHIGAN,MONTMORENCY,26119,4171,1628,5799,28.073805828591137,Trump
MICHIGAN,MUSKEGON,26121,45133,45643,90776,50.28091125407597,Biden
MICHIGAN,NEWAYGO,26123,18857,7873,26730,29.453797231575006,Trump
MICHIGAN,OAKLAND,26125,325971,434148,760119,57.11579371124784,Biden
MICHIGAN,OCEANA,26127,8892,4944,13836,35.73287077189939,Trump
MICHIGAN,OGEMAW,26129,8253,3475,11728,29.62994542974079,Trump
MICHIGAN,ONTONAGON,26131,2358,1391,3749,37.10322752734063,Trump
MICHIGAN,OSCEOLA,26133,8928,3214,12142,26.470103772030967,Trump
MICHIGAN,OSCODA,26135,3466,1342,4808,27.911813643926784,Trump
MICHIGAN,OTSEGO,26137,9779,4743,14522,32.660790524721115,Trump
MICHIGAN,OTTAWA,26139,100913,64705,165618,39.0688210218696,Trump
MICHIGAN,PRESQUE ISLE,26141,5342,2911,8253,35.272022294923055,Trump
MICHIGAN,ROSCOMMON,26143,9670,5166,14836,34.8207063898625,Trump
MICHIGAN,SAGINAW,26145,50785,51088,101873,50.14871457599167,Biden
MICHIGAN,SANILAC,26151,16194,5966,22160,26.922382671480143,Trump
MICHIGAN,SCHOOLCRAFT,26153,3090,1589,4679,33.96024791622141,Trump
MICHIGAN,SHIAWASSEE,26155,23149,15347,38496,39.86647963424772,Trump
MICHIGAN,ST. CLAIR,26147,59185,31363,90548,34.63687767813756,Trump
MICHIGAN,ST. JOSEPH,26149,18127,9262,27389,33.816495673445544,Trump
MICHIGAN,TUSCOLA,26157,20297,8712,29009,30.032059016167395,Trump
MICHIGAN,VAN BUREN,26159,21591,16803,38394,43.76465072667604,Trump
MICHIGAN,WASHTENAW,26161,56241,157136,213377,73.64242631586347,Biden
MICHIGAN,WAYNE,26163,264553,597170,861723,69.29953128789646,Biden
MICHIGAN,WEXFORD,26165,12102,5838,17940,32.541806020066886,Trump
MINNESOTA,AITKIN,27001,6258,3607,9865,36.5636087176888,Trump
MINNESOTA,ANOKA,27003,104902,100893,205795,49.02597244831021,Trump
MINNESOTA,BECKER,27005,12438,6589,19027,34.62973668996689,Trump
MINNESOTA,BELTRAMI,27007,12188,11426,23614,48.386550351486406,Trump
MINNESOTA,BENTON,27009,14382,7280,21662,33.60723848213462,Trump
MINNESOTA,BIG STONE,27011,1863,1053,2916,36.11111111111111,Trump
MINNESOTA,BLUE EARTH,27013,16731,18330,35061,52.28031145717463,Biden
MINNESOTA,BROWN,27015,9552,4753,14305,33.226144704648725,Trump
MINNESOTA,CARLTON,27017,9791,10098,19889,50.771783397858115,Biden
MINNESOTA,CARVER,27019,34009,30774,64783,47.503203000787245,Trump
MINNESOTA,CASS,27021,11620,6342,17962,35.307872174590806,Trump
MINNESOTA,CHIPPEWA,27023,4250,2226,6476,34.373069796170476,Trump
MINNESOTA,CHISAGO,27025,21916,11806,33722,35.00978589644742,Trump
MINNESOTA,CLAY,27027,15043,16357,31400,52.09235668789809,Biden
MINNESOTA,CLEARWATER,27029,3372,1260,4632,27.202072538860104,Trump
MINNESOTA,COOK,27031,1203,2496,3699,67.47769667477696,Biden
MINNESOTA,COTTONWOOD,27033,4165,1834,5999,30.57176196032672,Trump
MINNESOTA,CROW WING,27035,25676,13726,39402,34.835795137302675,Trump
MINNESOTA,DAKOTA,27037,109638,146155,255793,57.13799830331558,Biden
MINNESOTA,DODGE,27039,7783,4079,11862,34.387118529758894,Trump
MINNESOTA,DOUGLAS,27041,15799,7868,23667,33.24460218870156,Trump
MINNESOTA,FARIBAULT,27043,5191,2531,7722,32.77648277648277,Trump
MINNESOTA,FILLMORE,27045,7301,4551,11852,38.39858251771852,Trump
MINNESOTA,FREEBORN,27047,9578,6889,16467,41.835185522560266,Trump
MINNESOTA,GOODHUE,27049,16052,11806,27858,42.37920884485605,Trump
MINNESOTA,GRANT,27051,2269,1300,3569,36.424768842813116,Trump
MINNESOTA,HENNEPIN,27053,205973,532623,738596,72.11290069266555,Biden
MINNESOTA,HOUSTON,27055,6334,4853,11187,43.38070975239117,Trump
MINNESOTA,HUBBARD,27057,8202,4462,12664,35.23373341756159,Trump
MINNESOTA,ISANTI,27059,16491,7138,23629,30.208641923060647,Trump
MINNESOTA,ITASCA,27061,15239,10786,26025,41.4447646493756,Trump
MINNESOTA,JACKSON,27063,3948,1745,5693,30.651677498682595,Trump
MINNESOTA,KANABEC,27065,6278,2774,9052,30.64516129032258,Trump
MINNESOTA,KANDIYOHI,27067,14437,8440,22877,36.892949250338766,Trump
MINNESOTA,KITTSON,27069,1546,1006,2552,39.42006269592476,Trump
MINNESOTA,KOOCHICHING,27071,4131,2659,6790,39.16053019145803,Trump
MINNESOTA,LAC QUI PARLE,27073,2528,1446,3974,36.38651233014595,Trump
MINNESOTA,LAKE,27075,3393,3647,7040,51.80397727272727,Biden
MINNESOTA,LAKE OF THE WOODS,27077,1704,671,2375,28.25263157894737,Trump
MINNESOTA,LE SUEUR,27079,10775,5672,16447,34.48653249832797,Trump
MINNESOTA,LINCOLN,27081,2121,937,3058,30.640941792020925,Trump
MINNESOTA,LYON,27083,7979,4634,12613,36.73987156108777,Trump
MINNESOTA,MAHNOMEN,27087,1142,1112,2254,49.33451641526176,Trump
MINNESOTA,MARSHALL,27089,3721,1295,5016,25.81738437001595,Trump
MINNESOTA,MARTIN,27091,7480,3305,10785,30.644413537320354,Trump
MINNESOTA,MCLEOD,27085,13986,6413,20399,31.43781557919506,Trump
MINNESOTA,MEEKER,27093,9359,3867,13226,29.23786481173446,Trump
MINNESOTA,MILLE LACS,27095,9952,4404,14356,30.677068821398716,Trump
MINNESOTA,MORRISON,27097,14821,4367,19188,22.75901605169898,Trump
MINNESOTA,MOWER,27099,10025,8899,18924,47.02494187275417,Trump
MINNESOTA,MURRAY,27101,3363,1449,4812,30.11221945137157,Trump
MINNESOTA,NICOLLET,27103,9018,9622,18640,51.62017167381975,Biden
MINNESOTA,NOBLES,27105,5600,2933,8533,34.372436423297785,Trump
MINNESOTA,NORMAN,27107,1953,1404,3357,41.8230563002681,Trump
MINNESOTA,OLMSTED,27109,39692,49491,89183,55.49376002152877,Biden
MINNESOTA,OTTER TAIL,27111,23800,11958,35758,33.44146764360423,Trump
MINNESOTA,PENNINGTON,27113,4532,2568,7100,36.16901408450704,Trump
MINNESOTA,PINE,27115,10256,5419,15675,34.570972886762355,Trump
MINNESOTA,PIPESTONE,27117,3553,1306,4859,26.877958427660015,Trump
MINNESOTA,POLK,27119,9865,5439,15304,35.539728175640356,Trump
MINNESOTA,POPE,27121,4417,2477,6894,35.9297940237888,Trump
MINNESOTA,RAMSEY,27123,77376,211620,288996,73.22592700244986,Biden
MINNESOTA,RED LAKE,27125,1454,691,2145,32.214452214452216,Trump
MINNESOTA,REDWOOD,27127,5771,2355,8126,28.981048486340143,Trump
MINNESOTA,RENVILLE,27129,5467,2496,7963,31.344970488509354,Trump
MINNESOTA,RICE,27131,17464,17402,34866,49.91108816612172,Trump
MINNESOTA,ROCK,27133,3583,1556,5139,30.278264253745863,Trump
MINNESOTA,ROSEAU,27135,6065,2188,8253,26.511571549739486,Trump
MINNESOTA,SAINT LOUIS,27137,49017,67704,116721,58.00498624926106,Biden
MINNESOTA,SCOTT,27139,45872,40040,85912,46.60582922059782,Trump
MINNESOTA,SHERBURNE,27141,36222,18065,54287,33.27684344318161,Trump
MINNESOTA,SIBLEY,27143,5864,2417,8281,29.187296220263253,Trump
MINNESOTA,STEARNS,27145,50959,31879,82838,38.48354619860451,Trump
MINNESOTA,STEELE,27147,12656,7917,20573,38.48247703300443,Trump
MINNESOTA,STEVENS,27149,3044,1922,4966,38.7031816351188,Trump
MINNESOTA,SWIFT,27151,3316,1784,5100,34.98039215686274,Trump
MINNESOTA,TODD,27153,9753,3286,13039,25.201319119564385,Trump
MINNESOTA,TRAVERSE,27155,1172,661,1833,36.06110201854883,Trump
MINNESOTA,WABASHA,27157,8153,4696,12849,36.547591252237524,Trump
MINNESOTA,WADENA,27159,5520,2023,7543,26.819567811215695,Trump
MINNESOTA,WASECA,27161,6624,3496,10120,34.54545454545455,Trump
MINNESOTA,WASHINGTON,27163,73764,89165,162929,54.72629182036347,Biden
MINNESOTA,WATONWAN,27165,3103,1987,5090,39.03732809430255,Trump
MINNESOTA,WILKIN,27167,2328,1026,3354,30.590339892665476,Trump
MINNESOTA,WINONA,27169,13227,13333,26560,50.19954819277108,Biden
MINNESOTA,WRIGHT,27171,51973,28430,80403,35.35937713766899,Trump
MINNESOTA,YELLOW MEDICINE,27173,3734,1688,5422,31.132423459977872,Trump
MISSISSIPPI,ADAMS,28001,5696,7917,13613,58.157643429075144,Biden
MISSISSIPPI,ALCORN,28003,12818,2782,15600,17.833333333333336,Trump
MISSISSIPPI,AMITE,28005,4503,2620,7123,36.78225466797698,Trump
MISSISSIPPI,ATTALA,28007,5178,3542,8720,40.61926605504587,Trump
MISSISSIPPI,BENTON,28009,2570,1679,4249,39.51518004236291,Trump
MISSISSIPPI,BOLIVAR,28011,4671,8904,13575,65.59116022099447,Biden
MISSISSIPPI,CALHOUN,28013,4625,1902,6527,29.140493335376128,Trump
MISSISSIPPI,CARROLL,28015,3924,1729,5653,30.585529807182027,Trump
MISSISSIPPI,CHICKASAW,28017,4175,3810,7985,47.71446462116468,Trump
MISSISSIPPI,CHOCTAW,28019,3001,1185,4186,28.30864787386527,Trump
MISSISSIPPI,CLAIBORNE,28021,603,3772,4375,86.21714285714286,Biden
MISSISSIPPI,CLARKE,28023,5417,2838,8255,34.37916414294367,Trump
MISSISSIPPI,CLAY,28025,4181,5844,10025,58.29426433915212,Biden
MISSISSIPPI,COAHOMA,28027,2375,6020,8395,71.70935080405003,Biden
MISSISSIPPI,COPIAH,28029,6250,6470,12720,50.86477987421384,Biden
MISSISSIPPI,COVINGTON,28031,5854,3416,9270,36.850053937432584,Trump
MISSISSIPPI,DESOTO,28033,46462,28265,74727,37.8243472908052,Trump
MISSISSIPPI,FORREST,28035,17290,13755,31045,44.306651634723785,Trump
MISSISSIPPI,FRANKLIN,28037,2923,1480,4403,33.61344537815126,Trump
MISSISSIPPI,GEORGE,28039,9713,1218,10931,11.142621901015461,Trump
MISSISSIPPI,GREENE,28041,4794,966,5760,16.770833333333332,Trump
MISSISSIPPI,GRENADA,28043,6081,4734,10815,43.77253814147018,Trump
MISSISSIPPI,HANCOCK,28045,16132,4504,20636,21.82593525877108,Trump
MISSISSIPPI,HARRISON,28047,46822,27728,74550,37.19382964453387,Trump
MISSISSIPPI,HINDS,28049,25141,73550,98691,74.52553930956218,Biden
MISSISSIPPI,HOLMES,28051,1369,6588,7957,82.79502324996858,Biden
MISSISSIPPI,HUMPHREYS,28053,1118,3016,4134,72.95597484276729,Biden
MISSISSIPPI,ISSAQUENA,28055,308,355,663,53.54449472096531,Biden
MISSISSIPPI,ITAWAMBA,28057,9438,1249,10687,11.687096472349584,Trump
MISSISSIPPI,JACKSON,28059,36295,17375,53670,32.37376560462083,Trump
MISSISSIPPI,JASPER,28061,4302,4341,8643,50.225616105518924,Biden
MISSISSIPPI,JEFFERSON,28063,531,3327,3858,86.23639191290823,Biden
MISSISSIPPI,JEFFERSON DAVIS,28065,2534,3599,6133,58.68253709440731,Biden
MISSISSIPPI,JONES,28067,21226,8517,29743,28.635309148371046,Trump
MISSISSIPPI,KEMPER,28069,1787,2887,4674,61.767222935387245,Biden
MISSISSIPPI,LAFAYETTE,28071,12949,10070,23019,43.74647030713758,Trump
MISSISSIPPI,LAMAR,28073,20704,7340,28044,26.173156468406788,Trump
MISSISSIPPI,LAUDERDALE,28075,17967,12960,30927,41.90513143854884,Trump
MISSISSIPPI,LAWRENCE,28077,4285,2260,6545,34.53017570664629,Trump
MISSISSIPPI,LEAKE,28079,5228,3897,9125,42.706849315068496,Trump
MISSISSIPPI,LEE,28081,24207,12189,36396,33.489943949884605,Trump
MISSISSIPPI,LEFLORE,28083,3129,7648,10777,70.9659459961028,Biden
MISSISSIPPI,LINCOLN,28085,11596,5040,16636,30.29574416927146,Trump
MISSISSIPPI,LOWNDES,28087,13800,13087,26887,48.67408041060736,Trump
MISSISSIPPI,MADISON,28089,31091,24440,55531,44.011453062253516,Trump
MISSISSIPPI,MARION,28091,8273,3787,12060,31.401326699834165,Trump
MISSISSIPPI,MARSHALL,28093,7566,8057,15623,51.57140113934584,Biden
MISSISSIPPI,MONROE,28095,11177,5874,17051,34.449592399272774,Trump
MISSISSIPPI,MONTGOMERY,28097,2917,2121,5038,42.100039698292974,Trump
MISSISSIPPI,NESHOBA,28099,8320,3260,11580,28.151986183074268,Trump
MISSISSIPPI,NEWTON,28101,6997,3075,10072,30.530182684670372,Trump
MISSISSIPPI,NOXUBEE,28103,1240,4040,5280,76.51515151515152,Biden
MISSISSIPPI,OKTIBBEHA,28105,9004,10299,19303,53.354400870331034,Biden
MISSISSIPPI,PANOLA,28107,8060,7403,15463,47.875573950721076,Trump
MISSISSIPPI,PEARL RIVER,28109,19595,4148,23743,17.470412332055762,Trump
MISSISSIPPI,PERRY,28111,4500,1362,5862,23.23439099283521,Trump
MISSISSIPPI,PIKE,28113,8479,8646,17125,50.487591240875915,Biden
MISSISSIPPI,PONTOTOC,28115,11550,2614,14164,18.455238633154476,Trump
MISSISSIPPI,PRENTISS,28117,8370,2153,10523,20.45994488263803,Trump
MISSISSIPPI,QUITMAN,28119,1026,2150,3176,67.69521410579345,Biden
MISSISSIPPI,RANKIN,28121,50895,18847,69742,27.023888044506894,Trump
MISSISSIPPI,SCOTT,28123,6285,4330,10615,40.79133301931229,Trump
MISSISSIPPI,SHARKEY,28125,688,1465,2153,68.04458894565722,Biden
MISSISSIPPI,SIMPSON,28127,7635,4037,11672,34.58704592186429,Trump
MISSISSIPPI,SMITH,28129,6458,1791,8249,21.711722633046428,Trump
MISSISSIPPI,STONE,28131,5964,1802,7766,23.203708472830286,Trump
MISSISSIPPI,SUNFLOWER,28133,2799,6781,9580,70.78288100208768,Biden
MISSISSIPPI,TALLAHATCHIE,28135,2488,3105,5593,55.51582335061684,Biden
MISSISSIPPI,TATE,28137,8707,4183,12890,32.451512800620634,Trump
MISSISSIPPI,TIPPAH,28139,8054,1937,9991,19.387448703833453,Trump
MISSISSIPPI,TISHOMINGO,28141,7933,1059,8992,11.777135231316727,Trump
MISSISSIPPI,TUNICA,28143,926,2580,3506,73.58813462635482,Biden
MISSISSIPPI,UNION,28145,10373,2160,12533,17.234500917577595,Trump
MISSISSIPPI,WALTHALL,28147,4220,2835,7055,40.18426647767541,Trump
MISSISSIPPI,WARREN,28149,10365,10442,20807,50.18503388282789,Biden
MISSISSIPPI,WASHINGTON,28151,5300,12503,17803,70.22973656125372,Biden
MISSISSIPPI,WAYNE,28153,6307,3624,9931,36.49179337428255,Trump
MISSISSIPPI,WEBSTER,28155,4291,1043,5334,19.553805774278217,Trump
MISSISSIPPI,WILKINSON,28157,1324,2749,4073,67.49324821998528,Biden
MISSISSIPPI,WINSTON,28159,5112,4040,9152,44.14335664335665,Trump
MISSISSIPPI,YALOBUSHA,28161,3671,2785,6456,43.13816604708798,Trump
MISSISSIPPI,YAZOO,28163,4832,5496,10328,53.21456235476375,Biden
MISSOURI,ADAIR,29001,6413,3710,10123,36.64921465968586,Trump
MISSOURI,ANDREW,29003,7255,2351,9606,24.47428690401832,Trump
MISSOURI,ATCHISON,29005,2199,564,2763,20.412595005428884,Trump
MISSOURI,AUDRAIN,29007,7732,2704,10436,25.910310463779222,Trump
MISSOURI,BARRY,29009,12425,2948,15373,19.176478241072008,Trump
MISSOURI,BARTON,29011,5168,844,6012,14.038589487691283,Trump
MISSOURI,BATES,29013,6597,1672,8269,20.220099165558107,Trump
MISSOURI,BENTON,29015,8109,2180,10289,21.187676159004763,Trump
MISSOURI,BOLLINGER,29017,5167,750,5917,12.675342234240325,Trump
MISSOURI,BOONE,29019,38646,50064,88710,56.43557659790328,Biden
MISSOURI,BUCHANAN,29021,22450,13445,35895,37.456470260481964,Trump
MISSOURI,BUTLER,29023,14602,3301,17903,18.438250572529743,Trump
MISSOURI,CALDWELL,29025,3725,897,4622,19.407183037646043,Trump
MISSOURI,CALLAWAY,29027,14815,5870,20685,28.378051728305536,Trump
MISSOURI,CAMDEN,29029,18850,5652,24502,23.06750469349441,Trump
MISSOURI,CAPE GIRARDEAU,29031,28907,10760,39667,27.12582247208007,Trump
MISSOURI,CARROLL,29033,3706,786,4492,17.497773820124664,Trump
MISSOURI,CARTER,29035,2451,418,2869,14.56953642384106,Trump
MISSOURI,CASS,29037,37197,19052,56249,33.870824370211025,Trump
MISSOURI,CEDAR,29039,5788,1145,6933,16.515217077744122,Trump
MISSOURI,CHARITON,29041,3111,916,4027,22.74646138564688,Trump
MISSOURI,CHRISTIAN,29043,34920,11131,46051,24.171027773555405,Trump
MISSOURI,CLARK,29045,2672,678,3350,20.238805970149254,Trump
MISSOURI,CLAY,29047,64605,59400,124005,47.90129430264909,Trump
MISSOURI,CLINTON,29049,7799,2896,10695,27.078073866292662,Trump
MISSOURI,COLE,29051,26086,12694,38780,32.73336771531717,Trump
MISSOURI,COOPER,29053,6272,2249,8521,26.39361577279662,Trump
MISSOURI,CRAWFORD,29055,8725,2113,10838,19.496217014209265,Trump
MISSOURI,DADE,29057,3414,656,4070,16.117936117936118,Trump
MISSOURI,DALLAS,29059,6619,1380,7999,17.252156519564945,Trump
MISSOURI,DAVIESS,29061,3102,746,3848,19.386694386694387,Trump
MISSOURI,DEKALB,29063,3828,930,4758,19.546027742749054,Trump
MISSOURI,DENT,29065,5987,1056,7043,14.99361067726821,Trump
MISSOURI,DOUGLAS,29067,5898,1016,6914,14.69482210008678,Trump
MISSOURI,DUNKLIN,29069,8135,2200,10335,21.286889211417513,Trump
MISSOURI,FRANKLIN,29071,38058,14569,52627,27.68350846523648,Trump
MISSOURI,GASCONADE,29073,6222,1601,7823,20.465294643998465,Trump
MISSOURI,GENTRY,29075,2581,613,3194,19.192235441452723,Trump
MISSOURI,GREENE,29077,83630,55068,138698,39.7035285296111,Trump
MISSOURI,GRUNDY,29079,3585,799,4384,18.225364963503647,Trump
MISSOURI,HARRISON,29081,3198,597,3795,15.73122529644269,Trump
MISSOURI,HENRY,29083,8027,2619,10646,24.60078902874319,Trump
MISSOURI,HICKORY,29085,3966,1056,5022,21.02747909199522,Trump
MISSOURI,HOLT,29087,1976,338,2314,14.606741573033707,Trump
MISSOURI,HOWARD,29089,3553,1413,4966,28.453483689085786,Trump
MISSOURI,HOWELL,29091,15181,3218,18399,17.4900809826621,Trump
MISSOURI,IRON,29093,3596,945,4541,20.810394186302577,Trump
MISSOURI,JACKSON,29095,100142,92182,192324,47.93057548719869,Trump
MISSOURI,JASPER,29097,37728,13549,51277,26.42315268053903,Trump
MISSOURI,JEFFERSON,29099,77046,37523,114569,32.75144236224459,Trump
MISSOURI,JOHNSON,29101,15489,6974,22463,31.046609980857408,Trump
MISSOURI,KANSAS CITY,36000,26393,107660,134053,80.3115185784727,Biden
MISSOURI,KNOX,29103,1486,340,1826,18.619934282584886,Trump
MISSOURI,LACLEDE,29105,13762,2780,16542,16.805706686011366,Trump
MISSOURI,LAFAYETTE,29107,12273,4472,16745,26.70647954613317,Trump
MISSOURI,LAWRENCE,29109,14426,3214,17640,18.219954648526077,Trump
MISSOURI,LEWIS,29111,3553,984,4537,21.688340312982145,Trump
MISSOURI,LINCOLN,29113,21848,6607,28455,23.21911790546477,Trump
MISSOURI,LINN,29115,4363,1275,5638,22.61440227030862,Trump
MISSOURI,LIVINGSTON,29117,5267,1410,6677,21.11726823423693,Trump
MISSOURI,MACON,29121,6076,1662,7738,21.47841819591626,Trump
MISSOURI,MADISON,29123,4584,1019,5603,18.186685704087097,Trump
MISSOURI,MARIES,29125,3892,814,4706,17.297067573310667,Trump
MISSOURI,MARION,29127,9915,3202,13117,24.411069604330258,Trump
MISSOURI,MCDONALD,29119,7465,1439,8904,16.161275831087153,Trump
MISSOURI,MERCER,29129,1541,222,1763,12.592172433352241,Trump
MISSOURI,MILLER,29131,10176,2038,12214,16.68577042737842,Trump
MISSOURI,MISSISSIPPI,29133,3537,1178,4715,24.984093319194063,Trump
MISSOURI,MONITEAU,29135,5744,1308,7052,18.547929665343165,Trump
MISSOURI,MONROE,29137,3477,936,4413,21.2100611828688,Trump
MISSOURI,MONTGOMERY,29139,4465,1208,5673,21.293848052176976,Trump
MISSOURI,MORGAN,29141,7442,1924,9366,20.542387358530856,Trump
MISSOURI,NEW MADRID,29143,5447,1748,7195,24.294649061848506,Trump
MISSOURI,NEWTON,29145,22120,5818,27938,20.824683227145822,Trump
MISSOURI,NODAWAY,29147,6865,2853,9718,29.357892570487753,Trump
MISSOURI,OREGON,29149,3847,823,4670,17.623126338329765,Trump
MISSOURI,OSAGE,29151,6425,1037,7462,13.897078531224874,Trump
MISSOURI,OZARK,29153,4064,752,4816,15.614617940199334,Trump
MISSOURI,PEMISCOT,29155,4120,1560,5680,27.464788732394368,Trump
MISSOURI,PERRY,29157,7657,1664,9321,17.85216178521618,Trump
MISSOURI,PETTIS,29159,13854,4783,18637,25.66400171701454,Trump
MISSOURI,PHELPS,29161,13480,5637,19117,29.48684417011037,Trump
MISSOURI,PIKE,29163,5863,1717,7580,22.651715039577837,Trump
MISSOURI,PLATTE,29165,28917,27179,56096,48.45086993725043,Trump
MISSOURI,POLK,29167,11850,2885,14735,19.579233118425517,Trump
MISSOURI,PULASKI,29169,10329,3740,14069,26.58326817826427,Trump
MISSOURI,PUTNAM,29171,1984,361,2345,15.394456289978677,Trump
MISSOURI,RALLS,29173,4396,1205,5601,21.514015354401,Trump
MISSOURI,RANDOLPH,29175,8018,2485,10503,23.659906693325716,Trump
MISSOURI,RAY,29177,8345,3109,11454,27.143356032826958,Trump
MISSOURI,REYNOLDS,29179,2733,529,3262,16.21704475781729,Trump
MISSOURI,RIPLEY,29181,4839,833,5672,14.686177715091677,Trump
MISSOURI,SALINE,29195,6451,2904,9355,31.042223409941204,Trump
MISSOURI,SCHUYLER,29197,1606,373,1979,18.847902981303687,Trump
MISSOURI,SCOTLAND,29199,1560,388,1948,19.917864476386036,Trump
MISSOURI,SCOTT,29201,13769,3753,17522,21.418787809610777,Trump
MISSOURI,SHANNON,29203,3165,706,3871,18.238181348488762,Trump
MISSOURI,SHELBY,29205,2700,592,3292,17.98298906439854,Trump
MISSOURI,ST. CHARLES,29183,128389,89530,217919,41.08407252235923,Trump
MISSOURI,ST. CLAIR,29185,3932,988,4920,20.08130081300813,Trump
MISSOURI,ST. FRANCOIS,29187,20511,7044,27555,25.563418617310834,Trump
MISSOURI,ST. LOUIS CITY,29510,21474,110089,131563,83.67778174714775,Biden
MISSOURI,ST. LOUIS COUNTY,29189,199493,328151,527644,62.19174291757321,Biden
MISSOURI,STE. GENEVIEVE,29186,6630,2713,9343,29.037782296906776,Trump
MISSOURI,STODDARD,29207,11484,1819,13303,13.673607456964595,Trump
MISSOURI,STONE,29209,14800,3506,18306,19.152190538621216,Trump
MISSOURI,SULLIVAN,29211,1974,478,2452,19.494290375203917,Trump
MISSOURI,TANEY,29213,20508,5339,25847,20.656168994467443,Trump
MISSOURI,TEXAS,29215,9478,1716,11194,15.329640879042344,Trump
MISSOURI,VERNON,29217,7155,1903,9058,21.009052771031133,Trump
MISSOURI,WARREN,29219,13222,4769,17991,26.507698293591243,Trump
MISSOURI,WASHINGTON,29221,8047,1804,9851,18.312861638412343,Trump
MISSOURI,WAYNE,29223,4987,845,5832,14.489026063100138,Trump
MISSOURI,WEBSTER,29225,14880,3573,18453,19.362705251178667,Trump
MISSOURI,WORTH,29227,877,215,1092,19.68864468864469,Trump
MISSOURI,WRIGHT,29229,7453,1168,8621,13.548312260758614,Trump
MONTANA,BEAVERHEAD,30001,3923,1608,5531,29.07250045199783,Trump
MONTANA,BIG HORN,30003,2207,2491,4698,53.02256279267773,Biden
MONTANA,BLAINE,30005,1469,1589,3058,51.962066710268154,Biden
MONTANA,BROADWATER,30007,3173,835,4008,20.833333333333336,Trump
MONTANA,CARBON,30009,4468,2421,6889,35.14298156481347,Trump
MONTANA,CARTER,30011,775,74,849,8.716136631330977,Trump
MONTANA,CASCADE,30013,23315,15456,38771,39.86484743751773,Trump
MONTANA,CHOUTEAU,30015,1891,991,2882,34.38584316446912,Trump
MONTANA,CUSTER,30017,4205,1514,5719,26.47315964329428,Trump
MONTANA,DANIELS,30019,799,195,994,19.61770623742455,Trump
MONTANA,DAWSON,30021,3758,962,4720,20.38135593220339,Trump
MONTANA,DEER LODGE,30023,2186,2562,4748,53.95956192080876,Biden
MONTANA,FALLON,30025,1375,172,1547,11.118293471234647,Trump
MONTANA,FERGUS,30027,4869,1496,6365,23.503534956794972,Trump
MONTANA,FLATHEAD,30029,38321,20274,58595,34.60022186193361,Trump
MONTANA,GALLATIN,30031,31696,37044,68740,53.890020366598776,Biden
MONTANA,GARFIELD,30033,764,41,805,5.093167701863354,Trump
MONTANA,GLACIER,30035,1884,3610,5494,65.70804514015289,Biden
MONTANA,GOLDEN VALLEY,30037,414,78,492,15.853658536585366,Trump
MONTANA,GRANITE,30039,1419,638,2057,31.016042780748666,Trump
MONTANA,HILL,30041,3957,2981,6938,42.966272701066586,Trump
MONTANA,JEFFERSON,30043,5345,2625,7970,32.936010037641154,Trump
MONTANA,JUDITH BASIN,30045,1040,275,1315,20.912547528517113,Trump
MONTANA,LAKE,30047,9322,6916,16238,42.59145214927947,Trump
MONTANA,LEWIS AND CLARK,30049,21409,19743,41152,47.97579704510109,Trump
MONTANA,LIBERTY,30051,821,249,1070,23.271028037383175,Trump
MONTANA,LINCOLN,30053,8672,2835,11507,24.637177370296342,Trump
MONTANA,MADISON,30057,4191,1771,5962,29.704797047970477,Trump
MONTANA,MCCONE,30055,956,155,1111,13.95139513951395,Trump
MONTANA,MEAGHER,30059,833,258,1091,23.64802933088909,Trump
MONTANA,MINERAL,30061,1828,686,2514,27.287191726332537,Trump
MONTANA,MISSOULA,30063,26347,43357,69704,62.201595317341905,Biden
MONTANA,MUSSELSHELL,30065,2423,413,2836,14.562764456981665,Trump
MONTANA,PARK,30067,6025,5280,11305,46.70499778858912,Trump
MONTANA,PETROLEUM,30069,298,39,337,11.572700296735905,Trump
MONTANA,PHILLIPS,30071,1936,416,2352,17.687074829931973,Trump
MONTANA,PONDERA,30073,2031,903,2934,30.777096114519427,Trump
MONTANA,POWDER RIVER,30075,970,154,1124,13.701067615658364,Trump
MONTANA,POWELL,30077,2355,752,3107,24.203411651110397,Trump
MONTANA,PRAIRIE,30079,603,126,729,17.28395061728395,Trump
MONTANA,RAVALLI,30081,19114,8763,27877,31.434515909172433,Trump
MONTANA,RICHLAND,30083,4800,875,5675,15.418502202643172,Trump
MONTANA,ROOSEVELT,30085,1996,1910,3906,48.89912954429084,Trump
MONTANA,ROSEBUD,30087,2486,1199,3685,32.537313432835816,Trump
MONTANA,SANDERS,30089,5660,1820,7480,24.331550802139038,Trump
MONTANA,SHERIDAN,30091,1403,574,1977,29.033889731917046,Trump
MONTANA,SILVER BOW,30093,7745,10392,18137,57.29723769090809,Biden
MONTANA,STILLWATER,30095,4462,1156,5618,20.576717693129225,Trump
MONTANA,SWEET GRASS,30097,1840,549,2389,22.98032649644203,Trump
MONTANA,TETON,30099,2608,1007,3615,27.85615491009682,Trump
MONTANA,TOOLE,30101,1596,467,2063,22.636936500242367,Trump
MONTANA,TREASURE,30103,373,78,451,17.29490022172949,Trump
MONTANA,VALLEY,30105,3135,1030,4165,24.729891956782712,Trump
MONTANA,WHEATLAND,30107,823,225,1048,21.469465648854964,Trump
MONTANA,WIBAUX,30109,516,77,593,12.984822934232715,Trump
MONTANA,YELLOWSTONE,30111,50772,30679,81451,37.66559035493732,Trump
NEBRASKA,ADAMS,31001,10085,4213,14298,29.46565953280179,Trump
NEBRASKA,ANTELOPE,31003,3093,452,3545,12.750352609308885,Trump
NEBRASKA,ARTHUR,31005,260,21,281,7.473309608540925,Trump
NEBRASKA,BANNER,31007,362,43,405,10.617283950617285,Trump
NEBRASKA,BLAINE,31009,280,35,315,11.11111111111111,Trump
NEBRASKA,BOONE,31011,2653,499,3152,15.831218274111675,Trump
NEBRASKA,BOX BUTTE,31013,4002,1051,5053,20.79952503463289,Trump
NEBRASKA,BOYD,31015,1010,135,1145,11.790393013100436,Trump
NEBRASKA,BROWN,31017,1470,191,1661,11.499096929560505,Trump
NEBRASKA,BUFFALO,31019,16640,6350,22990,27.620704654197475,Trump
NEBRASKA,BURT,31021,2580,1063,3643,29.17924787263245,Trump
NEBRASKA,BUTLER,31023,3542,873,4415,19.773499433748583,Trump
NEBRASKA,CASS,31025,10121,4737,14858,31.881814510701307,Trump
NEBRASKA,CEDAR,31027,4174,725,4899,14.798938558889569,Trump
NEBRASKA,CHASE,31029,1740,226,1966,11.495422177009155,Trump
NEBRASKA,CHERRY,31031,2844,373,3217,11.594653403792353,Trump
NEBRASKA,CHEYENNE,31033,3813,855,4668,18.31619537275064,Trump
NEBRASKA,CLAY,31035,2848,632,3480,18.160919540229887,Trump
NEBRASKA,COLFAX,31037,2636,1025,3661,27.99781480469817,Trump
NEBRASKA,CUMING,31039,3507,870,4377,19.87662782727896,Trump
NEBRASKA,CUSTER,31041,5090,786,5876,13.37644656228727,Trump
NEBRASKA,DAKOTA,31043,3926,2744,6670,41.13943028485757,Trump
NEBRASKA,DAWES,31045,2931,1082,4013,26.962372290057314,Trump
NEBRASKA,DAWSON,31047,6524,2497,9021,27.679858108857115,Trump
NEBRASKA,DEUEL,31049,871,141,1012,13.932806324110672,Trump
NEBRASKA,DIXON,31051,2335,651,2986,21.801741460147355,Trump
NEBRASKA,DODGE,31053,10984,5544,16528,33.54307841239109,Trump
NEBRASKA,DOUGLAS,31055,119159,150350,269509,55.78663421258659,Biden
NEBRASKA,DUNDY,31057,883,105,988,10.62753036437247,Trump
NEBRASKA,FILLMORE,31059,2359,693,3052,22.706422018348622,Trump
NEBRASKA,FRANKLIN,31061,1437,276,1713,16.112084063047284,Trump
NEBRASKA,FRONTIER,31063,1229,189,1418,13.328631875881522,Trump
NEBRASKA,FURNAS,31065,2163,399,2562,15.573770491803279,Trump
NEBRASKA,GAGE,31067,7445,3385,10830,31.25577100646353,Trump
NEBRASKA,GARDEN,31069,1016,161,1177,13.678844519966017,Trump
NEBRASKA,GARFIELD,31071,933,133,1066,12.4765478424015,Trump
NEBRASKA,GOSPER,31073,893,215,1108,19.4043321299639,Trump
NEBRASKA,GRANT,31075,375,20,395,5.063291139240507,Trump
NEBRASKA,GREELEY,31077,1016,229,1245,18.393574297188756,Trump
NEBRASKA,HALL,31079,16189,7681,23870,32.17846669459573,Trump
NEBRASKA,HAMILTON,31081,4309,1118,5427,20.600700202690252,Trump
NEBRASKA,HARLAN,31083,1615,282,1897,14.865577227200843,Trump
NEBRASKA,HAYES,31085,494,34,528,6.4393939393939394,Trump
NEBRASKA,HITCHCOCK,31087,1264,175,1439,12.161223071577485,Trump
NEBRASKA,HOLT,31089,4769,686,5455,12.575618698441795,Trump
NEBRASKA,HOOKER,31091,376,59,435,13.563218390804598,Trump
NEBRASKA,HOWARD,31093,2786,648,3434,18.870122306348282,Trump
NEBRASKA,JEFFERSON,31095,2616,1016,3632,27.973568281938327,Trump
NEBRASKA,JOHNSON,31097,1518,647,2165,29.884526558891455,Trump
NEBRASKA,KEARNEY,31099,2822,701,3523,19.89781436275901,Trump
NEBRASKA,KEITH,31101,3544,763,4307,17.71534710935686,Trump
NEBRASKA,KEYA PAHA,31103,476,49,525,9.333333333333334,Trump
NEBRASKA,KIMBALL,31105,1563,268,1831,14.636810486073184,Trump
NEBRASKA,KNOX,31107,3721,905,4626,19.563337656722872,Trump
NEBRASKA,LANCASTER,31109,70092,82293,152385,54.00334678610099,Biden
NEBRASKA,LINCOLN,31111,13071,3692,16763,22.024697249895603,Trump
NEBRASKA,LOGAN,31113,407,38,445,8.539325842696629,Trump
NEBRASKA,LOUP,31115,370,75,445,16.853932584269664,Trump
NEBRASKA,MADISON,31119,11940,3478,15418,22.558049033597094,Trump
NEBRASKA,MCPHERSON,31117,275,17,292,5.821917808219178,Trump
NEBRASKA,MERRICK,31121,3419,743,4162,17.851994233541564,Trump
NEBRASKA,MORRILL,31123,2113,386,2499,15.446178471388555,Trump
NEBRASKA,NANCE,31125,1437,359,1796,19.988864142538976,Trump
NEBRASKA,NEMAHA,31127,2428,921,3349,27.50074649149,Trump
NEBRASKA,NUCKOLLS,31129,1857,409,2266,18.049426301853487,Trump
NEBRASKA,OTOE,31131,5649,2490,8139,30.59343899741983,Trump
NEBRASKA,PAWNEE,31133,1071,322,1393,23.115577889447238,Trump
NEBRASKA,PERKINS,31135,1321,199,1520,13.092105263157894,Trump
NEBRASKA,PHELPS,31137,4157,752,4909,15.318802200040741,Trump
NEBRASKA,PIERCE,31139,3462,480,3942,12.1765601217656,Trump
NEBRASKA,PLATTE,31141,12186,3260,15446,21.105787906254047,Trump
NEBRASKA,POLK,31143,2291,530,2821,18.787663948954272,Trump
NEBRASKA,RED WILLOW,31145,4525,811,5336,15.19865067466267,Trump
NEBRASKA,RICHARDSON,31147,3073,996,4069,24.477758663062176,Trump
NEBRASKA,ROCK,31149,744,84,828,10.144927536231885,Trump
NEBRASKA,SALINE,31151,3631,1986,5617,35.356952109667084,Trump
NEBRASKA,SARPY,31153,51979,41206,93185,44.21956323442614,Trump
NEBRASKA,SAUNDERS,31155,9108,3331,12439,26.778679958195994,Trump
NEBRASKA,SCOTTS BLUFF,31157,10952,4196,15148,27.70002640612622,Trump
NEBRASKA,SEWARD,31159,6490,2438,8928,27.3073476702509,Trump
NEBRASKA,SHERIDAN,31161,2292,340,2632,12.917933130699089,Trump
NEBRASKA,SHERMAN,31163,1322,343,1665,20.6006006006006,Trump
NEBRASKA,SIOUX,31165,642,72,714,10.084033613445378,Trump
NEBRASKA,STANTON,31167,2561,532,3093,17.20012932428063,Trump
NEBRASKA,THAYER,31169,2308,624,2932,21.282401091405184,Trump
NEBRASKA,THOMAS,31171,377,45,422,10.66350710900474,Trump
NEBRASKA,THURSTON,31173,1180,1122,2302,48.74022589052998,Trump
NEBRASKA,VALLEY,31175,1901,412,2313,17.812364894076957,Trump
NEBRASKA,WASHINGTON,31177,8583,3554,12137,29.282359726456292,Trump
NEBRASKA,WAYNE,31179,3055,1022,4077,25.067451557517785,Trump
NEBRASKA,WEBSTER,31181,1511,335,1846,18.147345612134345,Trump
NEBRASKA,WHEELER,31183,438,59,497,11.87122736418511,Trump
NEBRASKA,YORK,31185,5337,1630,6967,23.39600976029855,Trump
NEVADA,CARSON CITY,32510,16113,12735,28848,44.14517470881864,Trump
NEVADA,CHURCHILL,32001,9367,3048,12415,24.55094643576319,Trump
NEVADA,CLARK,32003,430809,521777,952586,54.77479198728514,Biden
NEVADA,DOUGLAS,32005,21623,11570,33193,34.85674690446781,Trump
NEVADA,ELKO,32007,16734,4555,21289,21.39602611677392,Trump
NEVADA,ESMERALDA,32009,395,72,467,15.417558886509635,Trump
NEVADA,EUREKA,32011,887,104,991,10.494450050454086,Trump
NEVADA,HUMBOLDT,32013,5877,1689,7566,22.323552735923872,Trump
NEVADA,LANDER,32015,2198,496,2694,18.411284335560506,Trump
NEVADA,LINCOLN,32017,2067,330,2397,13.76720901126408,Trump
NEVADA,LYON,32019,20906,8472,29378,28.837905915991556,Trump
NEVADA,MINERAL,32021,1420,824,2244,36.72014260249554,Trump
NEVADA,NYE,32023,17527,7287,24814,29.366486660756024,Trump
NEVADA,PERSHING,32027,1731,547,2278,24.012291483757682,Trump
NEVADA,STOREY,32029,1901,900,2801,32.131381649410926,Trump
NEVADA,WASHOE,32031,116653,128052,244705,52.32913099446272,Biden
NEVADA,WHITE PINE,32033,3400,856,4256,20.112781954887218,Trump
NEW HAMPSHIRE,BELKNAP,33001,20899,16894,37793,44.70139973010875,Trump
NEW HAMPSHIRE,CARROLL,33003,16150,16649,32799,50.760693923595234,Biden
NEW HAMPSHIRE,CHESHIRE,33005,17898,25522,43420,58.77936434822663,Biden
NEW HAMPSHIRE,COOS,33007,8617,7640,16257,46.99514055483792,Trump
NEW HAMPSHIRE,GRAFTON,33009,19905,33180,53085,62.50353207120656,Biden
NEW HAMPSHIRE,HILLSBOROUGH,33011,104625,122344,226969,53.90339649908137,Biden
NEW HAMPSHIRE,MERRIMACK,33013,39711,48533,88244,54.99864013417343,Biden
NEW HAMPSHIRE,ROCKINGHAM,33015,95858,100064,195922,51.07338634762814,Biden
NEW HAMPSHIRE,STRAFFORD,33017,30489,41721,72210,57.77731616119651,Biden
NEW HAMPSHIRE,SULLIVAN,33019,11508,12390,23898,51.84534270650264,Biden
NEW JERSEY,ATLANTIC,34001,64438,73808,138246,53.38888647772811,Biden
NEW JERSEY,BERGEN,34003,204417,285967,490384,58.31491239518418,Biden
NEW JERSEY,BURLINGTON,34005,103345,154595,257940,59.93448088702799,Biden
NEW JERSEY,CAMDEN,34007,86207,175065,261272,67.004883799259,Biden
NEW JERSEY,CAPE MAY,34009,33158,23941,57099,41.928930454123545,Trump
NEW JERSEY,CUMBERLAND,34011,28952,32742,61694,53.07161150192887,Biden
NEW JERSEY,ESSEX,34013,75475,266820,342295,77.95030602258286,Biden
NEW JERSEY,GLOUCESTER,34015,83340,86702,170042,50.988579292174876,Biden
NEW JERSEY,HUDSON,34017,65698,181452,247150,73.41776249241352,Biden
NEW JERSEY,HUNTERDON,34019,43153,39457,82610,47.762982689747005,Trump
NEW JERSEY,MERCER,34021,51641,122532,174173,70.3507432265621,Biden
NEW JERSEY,MIDDLESEX,34023,143467,226250,369717,61.195454901992605,Biden
NEW JERSEY,MONMOUTH,34025,191808,181291,373099,48.590588556924565,Trump
NEW JERSEY,MORRIS,34027,141134,153881,295015,52.160398623798784,Biden
NEW JERSEY,OCEAN,34029,217740,119456,337196,35.42628026429732,Trump
NEW JERSEY,PASSAIC,34031,92009,129097,221106,58.38692753701844,Biden
NEW JERSEY,SALEM,34033,18827,14479,33306,43.472647571008224,Trump
NEW JERSEY,SOMERSET,34035,71996,111173,183169,60.6942222756034,Biden
NEW JERSEY,SUSSEX,34037,51698,34481,86179,40.0109075296766,Trump
NEW JERSEY,UNION,34039,80002,170245,250247,68.03078558384317,Biden
NEW JERSEY,WARREN,34041,34769,24901,59670,41.73118820177643,Trump
NEW MEXICO,BERNALILLO,35001,116135,193757,309892,62.52404063351102,Biden
NEW MEXICO,CATRON,35003,1698,595,2293,25.94853903183602,Trump
NEW MEXICO,CHAVES,35005,15656,6381,22037,28.95584698461678,Trump
NEW MEXICO,CIBOLA,35006,3975,4745,8720,54.4151376146789,Biden
NEW MEXICO,COLFAX,35007,3271,2611,5882,44.38966337980279,Trump
NEW MEXICO,CURRY,35009,10444,4307,14751,29.198020473188258,Trump
NEW MEXICO,DE BACA,35011,656,231,887,26.042841037204056,Trump
NEW MEXICO,DONA ANA,35013,32802,47957,80759,59.382855161653815,Biden
NEW MEXICO,EDDY,35015,17454,5424,22878,23.708366115919226,Trump
NEW MEXICO,GRANT,35017,6553,7590,14143,53.66612458460015,Biden
NEW MEXICO,GUADALUPE,35019,917,1234,2151,57.368665736866575,Biden
NEW MEXICO,HARDING,35021,319,179,498,35.9437751004016,Trump
NEW MEXICO,HIDALGO,35023,1120,823,1943,42.357179619145654,Trump
NEW MEXICO,LEA,35025,16531,4061,20592,19.721250971250974,Trump
NEW MEXICO,LINCOLN,35027,6942,3194,10136,31.511444356748225,Trump
NEW MEXICO,LOS ALAMOS,35028,4278,7554,11832,63.84381338742393,Biden
NEW MEXICO,LUNA,35029,4408,3563,7971,44.699535817337846,Trump
NEW MEXICO,MCKINLEY,35031,7801,18029,25830,69.79868370112273,Biden
NEW MEXICO,MORA,35033,903,1745,2648,65.8987915407855,Biden
NEW MEXICO,OTERO,35035,14521,8485,23006,36.88168303920716,Trump
NEW MEXICO,QUAY,35037,2634,1170,3804,30.757097791798106,Trump
NEW MEXICO,RIO ARRIBA,35039,5408,10990,16398,67.02036833760215,Biden
NEW MEXICO,ROOSEVELT,35041,4634,1802,6436,27.998756991920448,Trump
NEW MEXICO,SAN JUAN,35045,32874,18083,50957,35.48678297387994,Trump
NEW MEXICO,SAN MIGUEL,35047,3421,7888,11309,69.74975683084268,Biden
NEW MEXICO,SANDOVAL,35043,34174,40588,74762,54.28961236992055,Biden
NEW MEXICO,SANTA FE,35049,18329,62530,80859,77.33214608145043,Biden
NEW MEXICO,SIERRA,35051,3542,2265,5807,39.0046495608748,Trump
NEW MEXICO,SOCORRO,35053,3255,3722,6977,53.34671062061058,Biden
NEW MEXICO,TAOS,35055,3715,13121,16836,77.93418864338322,Biden
NEW MEXICO,TORRANCE,35057,4772,2344,7116,32.939853850477796,Trump
NEW MEXICO,UNION,35059,1388,383,1771,21.626199887069454,Trump
NEW MEXICO,VALENCIA,35061,17364,14263,31627,45.09754323837228,Trump
NEW YORK,ALBANY,36001,51081,99474,150555,66.07153531931851,Biden
NEW YORK,ALLEGANY,36003,14135,6048,20183,29.965812812763215,Trump
NEW YORK,BRONX,36005,67740,355374,423114,83.99013031948837,Biden
NEW YORK,BROOME,36007,43800,47010,90810,51.76742649487942,Biden
NEW YORK,CATTARAUGUS,36009,22155,11879,34034,34.90333196215549,Trump
NEW YORK,CAYUGA,36011,19512,16149,35661,45.284764869184826,Trump
NEW YORK,CHAUTAUQUA,36013,34853,23087,57940,39.84639282015878,Trump
NEW YORK,CHEMUNG,36015,21922,16636,38558,43.14539135847295,Trump
NEW YORK,CHENANGO,36017,13482,8290,21772,38.07642844019842,Trump
NEW YORK,CLINTON,36019,16514,18364,34878,52.65210161133093,Biden
NEW YORK,COLUMBIA,36021,14464,20386,34850,58.496413199426115,Biden
NEW YORK,CORTLAND,36023,10789,10369,21158,49.00746762453918,Trump
NEW YORK,DELAWARE,36025,13387,9143,22530,40.58144695960941,Trump
NEW YORK,DUTCHESS,36027,66872,81443,148315,54.912180157098064,Biden
NEW YORK,ERIE,36029,197527,267174,464701,57.493743288695306,Biden
NEW YORK,ESSEX,36031,8976,9947,18923,52.56566083601966,Biden
NEW YORK,FRANKLIN,36033,9668,9253,18921,48.903334918873206,Trump
NEW YORK,FULTON,36035,15378,7931,23309,34.02548371873525,Trump
NEW YORK,GENESEE,36037,18876,9625,28501,33.77074488614434,Trump
NEW YORK,GREENE,36039,14271,10346,24617,42.02786692123329,Trump
NEW YORK,HAMILTON,36041,2225,1178,3403,34.6165148398472,Trump
NEW YORK,HERKIMER,36043,18870,9937,28807,34.49508799944458,Trump
NEW YORK,JEFFERSON,36045,25629,17307,42936,40.30883174958077,Trump
NEW YORK,KINGS,36047,202772,703310,906082,77.62101001896076,Biden
NEW YORK,LEWIS,36049,8894,3824,12718,30.06762069507784,Trump
NEW YORK,LIVINGSTON,36051,18182,12477,30659,40.69604357611142,Trump
NEW YORK,MADISON,36053,18408,14807,33215,44.579256360078276,Trump
NEW YORK,MONROE,36055,145661,225746,371407,60.78129922160864,Biden
NEW YORK,MONTGOMERY,36057,12745,7977,20722,38.49531898465399,Trump
NEW YORK,NASSAU,36059,326716,396504,723220,54.82481126075053,Biden
NEW YORK,NEW YORK,36061,85185,603040,688225,87.6225071742526,Biden
NEW YORK,NIAGARA,36063,56068,46029,102097,45.08359697150749,Trump
NEW YORK,ONEIDA,36065,57180,41567,98747,42.09444337549495,Trump
NEW YORK,ONONDAGA,36067,90619,138894,229513,60.51683346912811,Biden
NEW YORK,ONTARIO,36069,29039,29025,58064,49.987944337283,Trump
NEW YORK,ORANGE,36071,84996,84684,169680,49.90806223479491,Trump
NEW YORK,ORLEANS,36073,12126,5587,17713,31.541805453621635,Trump
NEW YORK,OSWEGO,36075,32138,21143,53281,39.68206302434263,Trump
NEW YORK,OTSEGO,36077,14382,12975,27357,47.42844610154622,Trump
NEW YORK,PUTNAM,36079,29283,24953,54236,46.008186444428055,Trump
NEW YORK,QUEENS,36081,212665,569038,781703,72.79465474739128,Biden
NEW YORK,RENSSELAER,36083,36500,40969,77469,52.884379558274915,Biden
NEW YORK,RICHMOND,36085,123320,90997,214317,42.45906764279082,Trump
NEW YORK,ROCKLAND,36087,73186,75802,148988,50.87792305420571,Biden
NEW YORK,SARATOGA,36091,61305,68471,129776,52.760911108371346,Biden
NEW YORK,SCHENECTADY,36093,30741,42465,73206,58.00754036554381,Biden
NEW YORK,SCHOHARIE,36095,9903,5345,15248,35.05377754459602,Trump
NEW YORK,SCHUYLER,36097,5621,3903,9524,40.98068038639227,Trump
NEW YORK,SENECA,36099,8329,6914,15243,45.3585252246933,Trump
NEW YORK,ST. LAWRENCE,36089,24608,19361,43969,44.03329618594919,Trump
NEW YORK,STEUBEN,36101,29474,15790,45264,34.884234711912335,Trump
NEW YORK,SUFFOLK,36103,375821,368000,743821,49.474268674855914,Trump
NEW YORK,SULLIVAN,36105,18665,15489,34154,45.350471394273,Trump
NEW YORK,TIOGA,36107,14791,9634,24425,39.44319344933469,Trump
NEW YORK,TOMPKINS,36109,11096,33619,44715,75.18506094151851,Biden
NEW YORK,ULSTER,36111,37590,57970,95560,60.663457513604016,Biden
NEW YORK,WARREN,36113,17699,17642,35341,49.91935712062477,Trump
NEW YORK,WASHINGTON,36115,15941,11565,27506,42.045371918854066,Trump
NEW YORK,WAYNE,36117,26204,17456,43660,39.98167659184608,Trump
NEW YORK,WESTCHESTER,36119,144713,312371,457084,68.33995501920872,Biden
NEW YORK,WYOMING,36121,13898,5073,18971,26.740814928048074,Trump
NEW YORK,YATES,36123,6208,4219,10427,40.46226143665484,Trump
NORTH CAROLINA,ALAMANCE,37001,46056,38825,84881,45.740507298453124,Trump
NORTH CAROLINA,ALEXANDER,37003,15888,4145,20033,20.690860080866567,Trump
NORTH CAROLINA,ALLEGHANY,37005,4527,1486,6013,24.713121569931815,Trump
NORTH CAROLINA,ANSON,37007,5321,5789,11110,52.10621062106211,Biden
NORTH CAROLINA,ASHE,37009,11451,4164,15615,26.666666666666668,Trump
NORTH CAROLINA,AVERY,37011,7172,2191,9363,23.400619459574923,Trump
NORTH CAROLINA,BEAUFORT,37013,16437,9633,26070,36.95051783659379,Trump
NORTH CAROLINA,BERTIE,37015,3817,5939,9756,60.87535875358754,Biden
NORTH CAROLINA,BLADEN,37017,9676,7326,17002,43.08904834725327,Trump
NORTH CAROLINA,BRUNSWICK,37019,55850,33310,89160,37.35980260206371,Trump
NORTH CAROLINA,BUNCOMBE,37021,62412,96515,158927,60.72913979374178,Biden
NORTH CAROLINA,BURKE,37023,31019,13118,44137,29.721095679361987,Trump
NORTH CAROLINA,CABARRUS,37025,63237,52162,115399,45.20143155486616,Trump
NORTH CAROLINA,CALDWELL,37027,32119,10245,42364,24.183268813143236,Trump
NORTH CAROLINA,CAMDEN,37029,4312,1537,5849,26.27799623867328,Trump
NORTH CAROLINA,CARTERET,37031,30028,12093,42121,28.710144583461933,Trump
NORTH CAROLINA,CASWELL,37033,7089,4860,11949,40.672859653527496,Trump
NORTH CAROLINA,CATAWBA,37035,56588,25689,82277,31.22257739100842,Trump
NORTH CAROLINA,CHATHAM,37037,21186,26787,47973,55.837658683009195,Biden
NORTH CAROLINA,CHEROKEE,37039,12628,3583,16211,22.10227623218802,Trump
NORTH CAROLINA,CHOWAN,37041,4471,3247,7718,42.070484581497794,Trump
NORTH CAROLINA,CLAY,37043,5112,1699,6811,24.94494200557921,Trump
NORTH CAROLINA,CLEVELAND,37045,33798,16955,50753,33.40689220341655,Trump
NORTH CAROLINA,COLUMBUS,37047,16832,9446,26278,35.94641905776695,Trump
NORTH CAROLINA,CRAVEN,37049,31032,21148,52180,40.52893829053277,Trump
NORTH CAROLINA,CUMBERLAND,37051,60032,84469,144501,58.45565082594584,Biden
NORTH CAROLINA,CURRITUCK,37053,11657,4195,15852,26.463537723946505,Trump
NORTH CAROLINA,DARE,37055,13938,9936,23874,41.61849710982659,Trump
NORTH CAROLINA,DAVIDSON,37057,64658,22636,87294,25.93076270992279,Trump
NORTH CAROLINA,DAVIE,37059,18228,6713,24941,26.91552062868369,Trump
NORTH CAROLINA,DUPLIN,37061,13793,8767,22560,38.86081560283688,Trump
NORTH CAROLINA,DURHAM,37063,32459,144688,177147,81.67679949420538,Biden
NORTH CAROLINA,EDGECOMBE,37065,9206,16089,25295,63.605455623641035,Biden
NORTH CAROLINA,FORSYTH,37067,85064,113033,198097,57.05942038496292,Biden
NORTH CAROLINA,FRANKLIN,37069,20901,15879,36780,43.17292006525285,Trump
NORTH CAROLINA,GASTON,37071,73033,40959,113992,35.93146887500877,Trump
NORTH CAROLINA,GATES,37073,3367,2546,5913,43.0576695416878,Trump
NORTH CAROLINA,GRAHAM,37075,3710,905,4615,19.609967497291443,Trump
NORTH CAROLINA,GRANVILLE,37077,16647,14565,31212,46.66474432910419,Trump
NORTH CAROLINA,GREENE,37079,4874,3832,8706,44.015621410521476,Trump
NORTH CAROLINA,GUILFORD,37081,107294,173086,280380,61.73264854839861,Biden
NORTH CAROLINA,HALIFAX,37083,10080,15545,25625,60.66341463414634,Biden
NORTH CAROLINA,HARNETT,37085,35177,22093,57270,38.57691636109656,Trump
NORTH CAROLINA,HAYWOOD,37087,22834,13144,35978,36.53343710045028,Trump
NORTH CAROLINA,HENDERSON,37089,40032,27211,67243,40.46666567523757,Trump
NORTH CAROLINA,HERTFORD,37091,3479,7097,10576,67.10476550680787,Biden
NORTH CAROLINA,HOKE,37093,9453,11804,21257,55.52994307757445,Biden
NORTH CAROLINA,HYDE,37095,1418,1046,2464,42.451298701298704,Trump
NORTH CAROLINA,IREDELL,37097,67010,33888,100898,33.58639418026125,Trump
NORTH CAROLINA,JACKSON,37099,11356,9591,20947,45.786986203274935,Trump
NORTH CAROLINA,JOHNSTON,37101,68353,41257,109610,37.63981388559438,Trump
NORTH CAROLINA,JONES,37103,3280,2197,5477,40.11320065729414,Trump
NORTH CAROLINA,LEE,37105,16469,12143,28612,42.44023486648958,Trump
NORTH CAROLINA,LENOIR,37107,14590,13605,28195,48.25323638943075,Trump
NORTH CAROLINA,LINCOLN,37109,36341,13274,49615,26.75400584500655,Trump
NORTH CAROLINA,MACON,37113,14211,6230,20441,30.47796096081405,Trump
NORTH CAROLINA,MADISON,37115,7979,4901,12880,38.05124223602485,Trump
NORTH CAROLINA,MARTIN,37117,6532,5911,12443,47.504621072088725,Trump
NORTH CAROLINA,MCDOWELL,37111,16883,5832,22715,25.674664318732116,Trump
NORTH CAROLINA,MECKLENBURG,37119,179211,378107,557318,67.84403159417064,Biden
NORTH CAROLINA,MITCHELL,37121,7090,1867,8957,20.84403260020096,Trump
NORTH CAROLINA,MONTGOMERY,37123,8411,4327,12738,33.96922593813785,Trump
NORTH CAROLINA,MOORE,37125,36764,20779,57543,36.110387014927966,Trump
NORTH CAROLINA,NASH,37127,25827,25947,51774,50.115888283694524,Biden
NORTH CAROLINA,NEW HANOVER,37129,63331,66138,129469,51.08404328449281,Biden
NORTH CAROLINA,NORTHAMPTON,37131,3989,6069,10058,60.34002783853649,Biden
NORTH CAROLINA,ONSLOW,37133,46078,24266,70344,34.496190151256684,Trump
NORTH CAROLINA,ORANGE,37135,20176,63594,83770,75.91500537185149,Biden
NORTH CAROLINA,PAMLICO,37137,4849,2713,7562,35.876752181962445,Trump
NORTH CAROLINA,PASQUOTANK,37139,9770,9832,19602,50.1581471278441,Biden
NORTH CAROLINA,PENDER,37141,21956,11723,33679,34.808040618783224,Trump
NORTH CAROLINA,PERQUIMANS,37143,4903,2492,7395,33.69844489519946,Trump
NORTH CAROLINA,PERSON,37145,13184,8465,21649,39.10111321539101,Trump
NORTH CAROLINA,PITT,37147,38982,47252,86234,54.795092422942226,Biden
NORTH CAROLINA,POLK,37149,7689,4518,12207,37.01155074956992,Trump
NORTH CAROLINA,RANDOLPH,37151,56894,15618,72512,21.5385039717564,Trump
NORTH CAROLINA,RICHMOND,37153,11830,8754,20584,42.528177225029154,Trump
NORTH CAROLINA,ROBESON,37155,27806,19020,46826,40.618459830008966,Trump
NORTH CAROLINA,ROCKINGHAM,37157,31301,15992,47293,33.81472945256169,Trump
NORTH CAROLINA,ROWAN,37159,49297,23114,72411,31.92056455510903,Trump
NORTH CAROLINA,RUTHERFORD,37161,24891,9135,34026,26.84711691059778,Trump
NORTH CAROLINA,SAMPSON,37163,17411,10966,28377,38.64397223103217,Trump
NORTH CAROLINA,SCOTLAND,37165,7473,7186,14659,49.021079200491165,Trump
NORTH CAROLINA,STANLY,37167,25458,8129,33587,24.202816565933247,Trump
NORTH CAROLINA,STOKES,37169,20142,5286,25428,20.78810759792355,Trump
NORTH CAROLINA,SURRY,37171,27538,8721,36259,24.051959513500094,Trump
NORTH CAROLINA,SWAIN,37173,4161,2780,6941,40.0518657253998,Trump
NORTH CAROLINA,TRANSYLVANIA,37175,11636,8444,20080,42.05179282868526,Trump
NORTH CAROLINA,TYRRELL,37177,1044,758,1802,42.06437291897892,Trump
NORTH CAROLINA,UNION,37179,80382,48725,129107,37.74001409683441,Trump
NORTH CAROLINA,VANCE,37181,8391,12431,20822,59.70127749495726,Biden
NORTH CAROLINA,WAKE,37183,226197,393336,619533,63.48911196013771,Biden
NORTH CAROLINA,WARREN,37185,3752,6400,10152,63.04176516942475,Biden
NORTH CAROLINA,WASHINGTON,37187,2781,3396,6177,54.978144730451675,Biden
NORTH CAROLINA,WATAUGA,37189,14451,17122,31573,54.22987996072594,Biden
NORTH CAROLINA,WAYNE,37191,30709,24215,54924,44.08819459616925,Trump
NORTH CAROLINA,WILKES,37193,27592,7511,35103,21.39703159274136,Trump
NORTH CAROLINA,WILSON,37195,19581,20754,40335,51.454072145779094,Biden
NORTH CAROLINA,YADKIN,37197,15933,3763,19696,19.10540211210398,Trump
NORTH CAROLINA,YANCEY,37199,7516,3688,11204,32.91681542306319,Trump
NORTH DAKOTA,ADAMS,38001,981,258,1239,20.823244552058114,Trump
NORTH DAKOTA,BARNES,38003,3568,1820,5388,33.778767631774315,Trump
NORTH DAKOTA,BENSON,38005,1094,822,1916,42.90187891440501,Trump
NORTH DAKOTA,BILLINGS,38007,541,72,613,11.745513866231647,Trump
NORTH DAKOTA,BOTTINEAU,38009,2575,821,3396,24.175500588928152,Trump
NORTH DAKOTA,BOWMAN,38011,1395,228,1623,14.048059149722736,Trump
NORTH DAKOTA,BURKE,38013,994,137,1131,12.1131741821397,Trump
NORTH DAKOTA,BURLEIGH,38015,34744,14348,49092,29.22675792389799,Trump
NORTH DAKOTA,CASS,38017,42619,40311,82930,48.60846497045701,Trump
NORTH DAKOTA,CAVALIER,38019,1499,474,1973,24.02432843385707,Trump
NORTH DAKOTA,DICKEY,38021,1742,608,2350,25.872340425531913,Trump
NORTH DAKOTA,DIVIDE,38023,904,265,1169,22.668947818648416,Trump
NORTH DAKOTA,DUNN,38025,1951,342,2293,14.914958569559527,Trump
NORTH DAKOTA,EDDY,38027,854,383,1237,30.962004850444625,Trump
NORTH DAKOTA,EMMONS,38029,1738,237,1975,12,Trump
NORTH DAKOTA,FOSTER,38031,1362,373,1735,21.498559077809798,Trump
NORTH DAKOTA,GOLDEN VALLEY,38033,871,137,1008,13.59126984126984,Trump
NORTH DAKOTA,GRAND FORKS,38035,16987,12880,29867,43.124518699568085,Trump
NORTH DAKOTA,GRANT,38037,1145,207,1352,15.310650887573965,Trump
NORTH DAKOTA,GRIGGS,38039,907,308,1215,25.349794238683128,Trump
NORTH DAKOTA,HETTINGER,38041,1091,196,1287,15.229215229215228,Trump
NORTH DAKOTA,KIDDER,38043,1215,221,1436,15.389972144846798,Trump
NORTH DAKOTA,LAMOURE,38045,1645,527,2172,24.263351749539595,Trump
NORTH DAKOTA,LOGAN,38047,930,128,1058,12.098298676748582,Trump
NORTH DAKOTA,MCHENRY,38049,2364,564,2928,19.262295081967213,Trump
NORTH DAKOTA,MCINTOSH,38051,1153,261,1414,18.458274398868458,Trump
NORTH DAKOTA,MCKENZIE,38053,4482,814,5296,15.37009063444109,Trump
NORTH DAKOTA,MCLEAN,38055,4198,1230,5428,22.660280029476787,Trump
NORTH DAKOTA,MERCER,38057,3856,704,4560,15.43859649122807,Trump
NORTH DAKOTA,MORTON,38059,12243,3872,16115,24.02730375426621,Trump
NORTH DAKOTA,MOUNTRAIL,38061,2824,1256,4080,30.784313725490197,Trump
NORTH DAKOTA,NELSON,38063,1141,586,1727,33.93167342211928,Trump
NORTH DAKOTA,OLIVER,38065,918,129,1047,12.320916905444127,Trump
NORTH DAKOTA,PEMBINA,38067,2460,786,3246,24.214417744916823,Trump
NORTH DAKOTA,PIERCE,38069,1585,497,2082,23.87127761767531,Trump
NORTH DAKOTA,RAMSEY,38071,3577,1639,5216,31.422546012269937,Trump
NORTH DAKOTA,RANSOM,38073,1418,945,2363,39.99153618281845,Trump
NORTH DAKOTA,RENVILLE,38075,1065,220,1285,17.120622568093385,Trump
NORTH DAKOTA,RICHLAND,38077,5072,2510,7582,33.10472170931153,Trump
NORTH DAKOTA,ROLETTE,38079,1257,2482,3739,66.38138539716502,Biden
NORTH DAKOTA,SARGENT,38081,1266,738,2004,36.82634730538922,Trump
NORTH DAKOTA,SHERIDAN,38083,688,104,792,13.131313131313133,Trump
NORTH DAKOTA,SIOUX,38085,258,804,1062,75.70621468926554,Biden
NORTH DAKOTA,SLOPE,38087,380,44,424,10.377358490566039,Trump
NORTH DAKOTA,STARK,38089,12110,2499,14609,17.105893627216098,Trump
NORTH DAKOTA,STEELE,38091,652,392,1044,37.547892720306514,Trump
NORTH DAKOTA,STUTSMAN,38093,6994,2676,9670,27.67321613236815,Trump
NORTH DAKOTA,TOWNER,38095,830,317,1147,27.637314734088932,Trump
NORTH DAKOTA,TRAILL,38097,2522,1493,4015,37.18555417185554,Trump
NORTH DAKOTA,WALSH,38099,3324,1333,4657,28.62357741035001,Trump
NORTH DAKOTA,WARD,38101,19974,7293,27267,26.746616789525802,Trump
NORTH DAKOTA,WELLS,38103,1893,442,2335,18.92933618843683,Trump
NORTH DAKOTA,WILLIAMS,38105,11739,2169,13908,15.595340811044004,Trump
OHIO,ADAMS,39001,9870,2156,12026,17.927823050058205,Trump
OHIO,ALLEN,39003,33116,14149,47265,29.935470221093833,Trump
OHIO,ASHLAND,39005,19407,6541,25948,25.20810852474179,Trump
OHIO,ASHTABULA,39007,26890,16497,43387,38.02291008827529,Trump
OHIO,ATHENS,39009,10862,14772,25634,57.62658968557385,Biden
OHIO,AUGLAIZE,39011,20798,4651,25449,18.27576722071594,Trump
OHIO,BELMONT,39013,23560,9138,32698,27.94666340448957,Trump
OHIO,BROWN,39015,16480,4380,20860,20.99712368168744,Trump
OHIO,BUTLER,39017,114392,69613,184005,37.83212412706177,Trump
OHIO,CARROLL,39019,10745,3251,13996,23.228065161474706,Trump
OHIO,CHAMPAIGN,39021,14589,5062,19651,25.759503333163707,Trump
OHIO,CLARK,39023,39032,24076,63108,38.15047220637637,Trump
OHIO,CLERMONT,39025,74570,34092,108662,31.37435349984355,Trump
OHIO,CLINTON,39027,15488,4697,20185,23.26975476839237,Trump
OHIO,COLUMBIANA,39029,35726,13359,49085,27.21605378425181,Trump
OHIO,COSHOCTON,39031,12325,4125,16450,25.07598784194529,Trump
OHIO,CRAWFORD,39033,15436,4916,20352,24.15487421383648,Trump
OHIO,CUYAHOGA,39035,202699,416176,618875,67.24718238739649,Biden
OHIO,DARKE,39037,22004,4731,26735,17.695904245371235,Trump
OHIO,DEFIANCE,39039,13038,5981,19019,31.447499868552498,Trump
OHIO,DELAWARE,39041,66356,57735,124091,46.526339541143194,Trump
OHIO,ERIE,39043,22160,17493,39653,44.115199354399415,Trump
OHIO,FAIRFIELD,39045,50797,31224,82021,38.068299581814415,Trump
OHIO,FAYETTE,39047,9473,2975,12448,23.899421593830333,Trump
OHIO,FRANKLIN,39049,211237,409144,620381,65.95044013275712,Biden
OHIO,FULTON,39051,15731,6664,22395,29.756642107613306,Trump
OHIO,GALLIA,39053,10645,2990,13635,21.92885955262193,Trump
OHIO,GEAUGA,39055,34143,21201,55344,38.30767562879445,Trump
OHIO,GREENE,39057,52072,34798,86870,40.057557269483134,Trump
OHIO,GUERNSEY,39059,13407,4577,17984,25.45040035587189,Trump
OHIO,HAMILTON,39061,177886,246266,424152,58.06078952828232,Biden
OHIO,HANCOCK,39063,26310,11757,38067,30.885018519977937,Trump
OHIO,HARDIN,39065,9949,3062,13011,23.53393282607025,Trump
OHIO,HARRISON,39067,5792,1768,7560,23.386243386243386,Trump
OHIO,HENRY,39069,10479,4062,14541,27.934805034041677,Trump
OHIO,HIGHLAND,39071,15678,3799,19477,19.505057247009294,Trump
OHIO,HOCKING,39073,9737,3880,13617,28.493794521553937,Trump
OHIO,HOLMES,39075,10796,1994,12790,15.590304925723222,Trump
OHIO,HURON,39077,18956,7759,26715,29.043608459666853,Trump
OHIO,JACKSON,39079,11309,3311,14620,22.647058823529413,Trump
OHIO,JEFFERSON,39081,22828,10018,32846,30.499908664677587,Trump
OHIO,KNOX,39083,22340,8589,30929,27.77005399463287,Trump
OHIO,LAKE,39085,73278,55514,128792,43.103608919808686,Trump
OHIO,LAWRENCE,39087,20306,7489,27795,26.943694909156324,Trump
OHIO,LICKING,39089,59514,33055,92569,35.708498525424275,Trump
OHIO,LOGAN,39091,17964,5055,23019,21.960119900951387,Trump
OHIO,LORAIN,39093,79520,75667,155187,48.75859446989761,Trump
OHIO,LUCAS,39095,81763,115411,197174,58.532565145506,Biden
OHIO,MADISON,39097,13835,5698,19533,29.171146265294627,Trump
OHIO,MAHONING,39099,59903,57641,117544,49.03780711903627,Trump
OHIO,MARION,39101,19023,8269,27292,30.298255899164587,Trump
OHIO,MEDINA,39103,64598,39800,104398,38.12333569608613,Trump
OHIO,MEIGS,39105,8316,2492,10808,23.05699481865285,Trump
OHIO,MERCER,39107,19452,4030,23482,17.162081594412744,Trump
OHIO,MIAMI,39109,41371,15663,57034,27.46256618858926,Trump
OHIO,MONROE,39111,5463,1605,7068,22.70797962648557,Trump
OHIO,MONTGOMERY,39113,129034,135064,264098,51.14162167074343,Biden
OHIO,MORGAN,39115,5041,1725,6766,25.49512267218445,Trump
OHIO,MORROW,39117,14077,4048,18125,22.333793103448276,Trump
OHIO,MUSKINGUM,39119,27867,11971,39838,30.04919925699081,Trump
OHIO,NOBLE,39121,5135,1170,6305,18.556701030927837,Trump
OHIO,OTTAWA,39123,14628,9008,23636,38.111355559316294,Trump
OHIO,PAULDING,39125,7086,2213,9299,23.798257877191094,Trump
OHIO,PERRY,39127,12357,4098,16455,24.90428441203282,Trump
OHIO,PICKAWAY,39129,20593,7304,27897,26.182026741226654,Trump
OHIO,PIKE,39131,9157,3110,12267,25.352571940979864,Trump
OHIO,PORTAGE,39133,45990,35661,81651,43.67490906418782,Trump
OHIO,PREBLE,39135,17022,4493,21515,20.88310481059726,Trump
OHIO,PUTNAM,39137,16412,3195,19607,16.295200693629827,Trump
OHIO,RICHLAND,39139,41472,17640,59112,29.84165651644336,Trump
OHIO,ROSS,39141,22278,10557,32835,32.151667428049336,Trump
OHIO,SANDUSKY,39143,18896,10596,29492,35.928387359283875,Trump
OHIO,SCIOTO,39145,22609,9080,31689,28.65347596957935,Trump
OHIO,SENECA,39147,17086,8266,25352,32.60492268854529,Trump
OHIO,SHELBY,39149,20422,4465,24887,17.941093743721623,Trump
OHIO,STARK,39151,111097,75904,187001,40.59015727188625,Trump
OHIO,SUMMIT,39153,124833,151668,276501,54.85260451137609,Biden
OHIO,TRUMBULL,39155,55194,44519,99713,44.6471372840051,Trump
OHIO,TUSCARAWAS,39157,30458,12889,43347,29.734468359978777,Trump
OHIO,UNION,39159,21669,11141,32810,33.95611094178604,Trump
OHIO,VAN WERT,39161,11650,3067,14717,20.839845077121698,Trump
OHIO,VINTON,39163,4632,1331,5963,22.320979372798927,Trump
OHIO,WARREN,39165,87988,46069,134057,34.36523269952333,Trump
OHIO,WASHINGTON,39167,22307,9243,31550,29.29635499207607,Trump
OHIO,WAYNE,39169,36759,16660,53419,31.18740523034875,Trump
OHIO,WILLIAMS,39171,13452,4842,18294,26.467694326008527,Trump
OHIO,WOOD,39173,35757,30617,66374,46.12800192846597,Trump
OHIO,WYANDOT,39175,8462,2733,11195,24.41268423403305,Trump
OKLAHOMA,ADAIR,40001,5585,1387,6972,19.8938611589214,Trump
OKLAHOMA,ALFALFA,40003,1978,232,2210,10.497737556561086,Trump
OKLAHOMA,ATOKA,40005,4557,765,5322,14.374295377677566,Trump
OKLAHOMA,BEAVER,40007,1968,190,2158,8.8044485634847085,Trump
OKLAHOMA,BECKHAM,40009,6767,1048,7815,13.410108765195137,Trump
OKLAHOMA,BLAINE,40011,3136,688,3824,17.99163179916318,Trump
OKLAHOMA,BRYAN,40013,12344,3323,15667,21.210187017297503,Trump
OKLAHOMA,CADDO,40015,7013,2670,9683,27.574098936280077,Trump
OKLAHOMA,CANADIAN,40017,43550,16742,60292,27.768194785377826,Trump
OKLAHOMA,CARTER,40019,14699,4470,19169,23.318900307788617,Trump
OKLAHOMA,CHEROKEE,40021,11223,6027,17250,34.939130434782605,Trump
OKLAHOMA,CHOCTAW,40023,4698,1082,5780,18.719723183391004,Trump
OKLAHOMA,CIMARRON,40025,970,70,1040,6.730769230769231,Trump
OKLAHOMA,CLEVELAND,40027,66677,49827,116504,42.76848863558333,Trump
OKLAHOMA,COAL,40029,2091,374,2465,15.172413793103448,Trump
OKLAHOMA,COMANCHE,40031,20905,13747,34652,39.67159182731155,Trump
OKLAHOMA,COTTON,40033,2117,393,2510,15.657370517928287,Trump
OKLAHOMA,CRAIG,40035,4686,1217,5903,20.616635609012366,Trump
OKLAHOMA,CREEK,40037,23294,6577,29871,22.018010779685984,Trump
OKLAHOMA,CUSTER,40039,8060,2369,10429,22.715504842266757,Trump
OKLAHOMA,DELAWARE,40041,13557,3472,17029,20.388748605320338,Trump
OKLAHOMA,DEWEY,40043,2124,214,2338,9.153122326775023,Trump
OKLAHOMA,ELLIS,40045,1688,162,1850,8.756756756756756,Trump
OKLAHOMA,GARFIELD,40047,16970,4919,21889,22.472474759011376,Trump
OKLAHOMA,GARVIN,40049,8878,1865,10743,17.36014148748022,Trump
OKLAHOMA,GRADY,40051,18538,4144,22682,18.269993827704788,Trump
OKLAHOMA,GRANT,40053,1916,280,2196,12.750455373406194,Trump
OKLAHOMA,GREER,40055,1605,328,1933,16.968442834971547,Trump
OKLAHOMA,HARMON,40057,747,177,924,19.155844155844157,Trump
OKLAHOMA,HARPER,40059,1327,136,1463,9.295967190704033,Trump
OKLAHOMA,HASKELL,40061,4165,783,4948,15.82457558609539,Trump
OKLAHOMA,HUGHES,40063,3875,919,4794,19.16979557780559,Trump
OKLAHOMA,JACKSON,40065,6392,1646,8038,20.477730778800694,Trump
OKLAHOMA,JEFFERSON,40067,2026,319,2345,13.603411513859276,Trump
OKLAHOMA,JOHNSTON,40069,3441,738,4179,17.6597272074659,Trump
OKLAHOMA,KAY,40071,12834,4040,16874,23.942159535379876,Trump
OKLAHOMA,KINGFISHER,40073,5521,854,6375,13.39607843137255,Trump
OKLAHOMA,KIOWA,40075,2673,699,3372,20.729537366548044,Trump
OKLAHOMA,LATIMER,40077,3437,762,4199,18.14717789949988,Trump
OKLAHOMA,LE FLORE,40079,15213,3299,18512,17.82087294727744,Trump
OKLAHOMA,LINCOLN,40081,12013,2609,14622,17.842976337026396,Trump
OKLAHOMA,LOGAN,40083,15608,5455,21063,25.898494991216825,Trump
OKLAHOMA,LOVE,40085,3305,711,4016,17.704183266932272,Trump
OKLAHOMA,MAJOR,40093,3084,320,3404,9.400705052878966,Trump
OKLAHOMA,MARSHALL,40095,4891,1100,5991,18.360874645301283,Trump
OKLAHOMA,MAYES,40097,12749,3581,16330,21.92896509491733,Trump
OKLAHOMA,MCCLAIN,40087,15295,3582,18877,18.975472797584363,Trump
OKLAHOMA,MCCURTAIN,40089,9485,1858,11343,16.380146345763908,Trump
OKLAHOMA,MCINTOSH,40091,6172,2031,8203,24.759234426429355,Trump
OKLAHOMA,MURRAY,40099,4612,1156,5768,20.041608876560332,Trump
OKLAHOMA,MUSKOGEE,40101,16526,8027,24553,32.692542662811064,Trump
OKLAHOMA,NOBLE,40103,3821,1003,4824,20.791873963515755,Trump
OKLAHOMA,NOWATA,40105,3610,712,4322,16.473854696899583,Trump
OKLAHOMA,OKFUSKEE,40107,3058,896,3954,22.660596863935258,Trump
OKLAHOMA,OKLAHOMA,40109,145050,141724,286774,49.42010084596233,Trump
OKLAHOMA,OKMULGEE,40111,9668,4357,14025,31.06595365418895,Trump
OKLAHOMA,OSAGE,40113,14121,6002,20123,29.82656661531581,Trump
OKLAHOMA,OTTAWA,40115,8545,2686,11231,23.915946932597276,Trump
OKLAHOMA,PAWNEE,40117,5267,1363,6630,20.55806938159879,Trump
OKLAHOMA,PAYNE,40119,17813,10904,28717,37.97054009819967,Trump
OKLAHOMA,PITTSBURG,40121,13851,3768,17619,21.38600374595607,Trump
OKLAHOMA,PONTOTOC,40123,10805,4117,14922,27.590135370593753,Trump
OKLAHOMA,POTTAWATOMIE,40125,20240,7275,27515,26.44012356896238,Trump
OKLAHOMA,PUSHMATAHA,40127,4016,668,4684,14.26131511528608,Trump
OKLAHOMA,ROGER MILLS,40129,1629,168,1797,9.348914858096828,Trump
OKLAHOMA,ROGERS,40131,34031,9589,43620,21.983035304906007,Trump
OKLAHOMA,SEMINOLE,40133,6011,2150,8161,26.344810684965076,Trump
OKLAHOMA,SEQUOYAH,40135,12113,3035,15148,20.03564827039873,Trump
OKLAHOMA,STEPHENS,40137,15560,3154,18714,16.85369242278508,Trump
OKLAHOMA,TEXAS,40139,4505,894,5399,16.55862196703093,Trump
OKLAHOMA,TILLMAN,40141,2076,597,2673,22.334455667789,Trump
OKLAHOMA,TULSA,40143,150574,108996,259570,41.99098509072697,Trump
OKLAHOMA,WAGONER,40145,26165,8464,34629,24.441941725143664,Trump
OKLAHOMA,WASHINGTON,40147,17076,5790,22866,25.321437942797164,Trump
OKLAHOMA,WASHITA,40149,4086,598,4684,12.766865926558497,Trump
OKLAHOMA,WOODS,40151,2993,591,3584,16.489955357142858,Trump
OKLAHOMA,WOODWARD,40153,6611,1005,7616,13.195903361344538,Trump
OREGON,BAKER,41001,7352,2346,9698,24.190554753557432,Trump
OREGON,BENTON,41003,14878,35827,50705,70.65772606251849,Biden
OREGON,CLACKAMAS,41005,110509,139043,249552,55.71704494454062,Biden
OREGON,CLATSOP,41007,10218,12916,23134,55.83124405636725,Biden
OREGON,COLUMBIA,41009,17150,13835,30985,44.650637405196065,Trump
OREGON,COOS,41011,21829,14243,36072,39.48491905078731,Trump
OREGON,CROOK,41013,11287,3801,15088,25.192205726405092,Trump
OREGON,CURRY,41015,8484,6058,14542,41.65864392793288,Trump
OREGON,DESCHUTES,41017,55646,65962,121608,54.24149726991645,Biden
OREGON,DOUGLAS,41019,43298,19160,62458,30.676614685068365,Trump
OREGON,GILLIAM,41021,834,324,1158,27.979274611398964,Trump
OREGON,GRANT,41023,3545,929,4474,20.764416629414395,Trump
OREGON,HARNEY,41025,3475,894,4369,20.4623483634699,Trump
OREGON,HOOD RIVER,41027,3955,8764,12719,68.90478811227297,Biden
OREGON,JACKSON,41029,63869,59478,123347,48.22006210122662,Trump
OREGON,JEFFERSON,41031,7189,4393,11582,37.92954584700397,Trump
OREGON,JOSEPHINE,41033,31751,18451,50202,36.753515796183414,Trump
OREGON,KLAMATH,41035,25308,10388,35696,29.10129986553115,Trump
OREGON,LAKE,41037,3470,792,4262,18.582824964805255,Trump
OREGON,LANE,41039,80336,134366,214702,62.58255628731917,Biden
OREGON,LINCOLN,41041,12460,17385,29845,58.25096331043726,Biden
OREGON,LINN,41043,43486,26512,69998,37.87536786765336,Trump
OREGON,MALHEUR,41045,8187,3260,11447,28.479077487551326,Trump
OREGON,MARION,41047,79002,80872,159874,50.58483555800193,Biden
OREGON,MORROW,41049,3586,1371,4957,27.657857575146256,Trump
OREGON,MULTNOMAH,41051,82995,367249,450244,81.56666163235934,Biden
OREGON,POLK,41053,23732,22917,46649,49.12645501511286,Trump
OREGON,SHERMAN,41055,921,260,1181,22.01524132091448,Trump
OREGON,TILLAMOOK,41057,8354,8066,16420,49.12302070645554,Trump
OREGON,UMATILLA,41059,21270,10707,31977,33.48344122337931,Trump
OREGON,UNION,41061,10298,4254,14552,29.233095107201763,Trump
OREGON,WALLOWA,41063,3404,1625,5029,32.31258699542653,Trump
OREGON,WASCO,41065,7035,6604,13639,48.41997213871985,Trump
OREGON,WASHINGTON,41067,99073,209940,309013,67.93888930239181,Biden
OREGON,WHEELER,41069,711,217,928,23.38362068965517,Trump
OREGON,YAMHILL,41071,29551,27174,56725,47.90480387836051,Trump
PENNSYLVANIA,ADAMS,42001,37523,18207,55730,32.67001614929123,Trump
PENNSYLVANIA,ALLEGHENY,42003,282324,429065,711389,60.313696163421135,Biden
PENNSYLVANIA,ARMSTRONG,42005,27489,8457,35946,23.526957102320146,Trump
PENNSYLVANIA,BEAVER,42007,54759,38122,92881,41.04391640916872,Trump
PENNSYLVANIA,BEDFORD,42009,23025,4367,27392,15.94261098130841,Trump
PENNSYLVANIA,BERKS,42011,109736,92895,202631,45.844416698333426,Trump
PENNSYLVANIA,BLAIR,42013,45306,17636,62942,28.01944647453211,Trump
PENNSYLVANIA,BRADFORD,42015,21600,8046,29646,27.140255009107467,Trump
PENNSYLVANIA,BUCKS,42017,187367,204712,392079,52.21192667804192,Biden
PENNSYLVANIA,BUTLER,42019,74359,37508,111867,33.529101522343495,Trump
PENNSYLVANIA,CAMBRIA,42021,48085,21730,69815,31.12511637900165,Trump
PENNSYLVANIA,CAMERON,42023,1771,634,2405,26.361746361746363,Trump
PENNSYLVANIA,CARBON,42025,21984,11212,33196,33.77515363296782,Trump
PENNSYLVANIA,CENTRE,42027,36372,40055,76427,52.409488793227524,Biden
PENNSYLVANIA,CHESTER,42029,128565,182372,310937,58.65239582294806,Biden
PENNSYLVANIA,CLARION,42031,14578,4678,19256,24.293726630660572,Trump
PENNSYLVANIA,CLEARFIELD,42033,29203,9673,38876,24.88167506945159,Trump
PENNSYLVANIA,CLINTON,42035,11902,5502,17404,31.61342220179269,Trump
PENNSYLVANIA,COLUMBIA,42037,20098,10532,30630,34.38459027097617,Trump
PENNSYLVANIA,CRAWFORD,42039,28559,12924,41483,31.154930935563968,Trump
PENNSYLVANIA,CUMBERLAND,42041,77212,62245,139457,44.63382978265702,Trump
PENNSYLVANIA,DAUPHIN,42043,66408,78983,145391,54.32454553583097,Biden
PENNSYLVANIA,DELAWARE,42045,118532,206423,324955,63.52356480128017,Biden
PENNSYLVANIA,ELK,42047,12140,4522,16662,27.13959908774457,Trump
PENNSYLVANIA,ERIE,42049,66869,68286,135155,50.52421294069772,Biden
PENNSYLVANIA,FAYETTE,42051,41227,20444,61671,33.150102965737545,Trump
PENNSYLVANIA,FOREST,42053,1882,728,2610,27.892720306513407,Trump
PENNSYLVANIA,FRANKLIN,42055,57245,22422,79667,28.1446521144263,Trump
PENNSYLVANIA,FULTON,42057,6824,1085,7909,13.718548489063092,Trump
PENNSYLVANIA,GREENE,42059,12579,4911,17490,28.078902229845625,Trump
PENNSYLVANIA,HUNTINGDON,42061,17061,5445,22506,24.193548387096776,Trump
PENNSYLVANIA,INDIANA,42063,28089,12634,40723,31.02423691771235,Trump
PENNSYLVANIA,JEFFERSON,42065,17960,4527,22487,20.131631609374306,Trump
PENNSYLVANIA,JUNIATA,42067,9649,2253,11902,18.92959166526634,Trump
PENNSYLVANIA,LACKAWANNA,42069,52334,61991,114325,54.2234856767986,Biden
PENNSYLVANIA,LANCASTER,42071,160209,115847,276056,41.965036079636015,Trump
PENNSYLVANIA,LAWRENCE,42073,29597,15978,45575,35.058694459681846,Trump
PENNSYLVANIA,LEBANON,42075,46731,23932,70663,33.86779502710046,Trump
PENNSYLVANIA,LEHIGH,42077,84259,98288,182547,53.84257204993782,Biden
PENNSYLVANIA,LUZERNE,42079,86929,64873,151802,42.735273580058234,Trump
PENNSYLVANIA,LYCOMING,42081,41462,16971,58433,29.043519928807353,Trump
PENNSYLVANIA,MCKEAN,42083,14083,5098,19181,26.578384860017728,Trump
PENNSYLVANIA,MERCER,42085,36143,21067,57210,36.8239818213599,Trump
PENNSYLVANIA,MIFFLIN,42087,16670,4603,21273,21.637756780895973,Trump
PENNSYLVANIA,MONROE,42089,38726,44060,82786,53.22155920083106,Biden
PENNSYLVANIA,MONTGOMERY,42091,185460,319511,504971,63.27313845745597,Biden
PENNSYLVANIA,MONTOUR,42093,5844,3771,9615,39.21996879875195,Trump
PENNSYLVANIA,NORTHAMPTON,42095,83854,85087,168941,50.364920297618696,Biden
PENNSYLVANIA,NORTHUMBERLAND,42097,28952,12677,41629,30.45232890533042,Trump
PENNSYLVANIA,PERRY,42099,18293,5950,24243,24.543167099781378,Trump
PENNSYLVANIA,PHILADELPHIA,42101,132740,603790,736530,81.97765196258129,Biden
PENNSYLVANIA,PIKE,42103,19213,13019,32232,40.39153636137999,Trump
PENNSYLVANIA,POTTER,42105,7239,1726,8965,19.252649191299497,Trump
PENNSYLVANIA,SCHUYLKILL,42107,48871,20727,69598,29.781028190465243,Trump
PENNSYLVANIA,SNYDER,42109,13983,4910,18893,25.988461334885937,Trump
PENNSYLVANIA,SOMERSET,42111,31466,8654,40120,21.570289132602195,Trump
PENNSYLVANIA,SULLIVAN,42113,2619,921,3540,26.016949152542374,Trump
PENNSYLVANIA,SUSQUEHANNA,42115,15207,6236,21443,29.08175162057548,Trump
PENNSYLVANIA,TIOGA,42117,15742,4955,20697,23.94066772962265,Trump
PENNSYLVANIA,UNION,42119,12356,7475,19831,37.69351016085926,Trump
PENNSYLVANIA,VENANGO,42121,18569,7585,26154,29.001299992352987,Trump
PENNSYLVANIA,WARREN,42123,14237,6066,20303,29.8773580259075,Trump
PENNSYLVANIA,WASHINGTON,42125,72080,45088,117168,38.48149665437662,Trump
PENNSYLVANIA,WAYNE,42127,18637,9191,27828,33.027885582866176,Trump
PENNSYLVANIA,WESTMORELAND,42129,130218,72129,202347,35.64619193761212,Trump
PENNSYLVANIA,WYOMING,42131,9936,4704,14640,32.131147540983605,Trump
PENNSYLVANIA,YORK,42133,146733,88114,234847,37.51974689904491,Trump
RHODE ISLAND,BRISTOL,44001,9745,18050,27795,64.93973736283503,Biden
RHODE ISLAND,FEDERAL PRECINCT,NA,85,1276,1361,93.75459221160911,Biden
RHODE ISLAND,KENT,44003,42001,49113,91114,53.9028030818535,Biden
RHODE ISLAND,NEWPORT,44005,15722,29486,45208,65.2229693859494,Biden
RHODE ISLAND,PROVIDENCE,44007,102551,165012,267563,61.67220430328558,Biden
RHODE ISLAND,WASHINGTON,44009,29818,44549,74367,59.90425860932941,Biden
SOUTH CAROLINA,ABBEVILLE,45001,8215,4101,12316,33.29814874959403,Trump
SOUTH CAROLINA,AIKEN,45003,51589,32275,83864,38.48492797863207,Trump
SOUTH CAROLINA,ALLENDALE,45005,835,2718,3553,76.49873346467774,Biden
SOUTH CAROLINA,ANDERSON,45007,67565,27169,94734,28.67924926636688,Trump
SOUTH CAROLINA,BAMBERG,45009,2417,4010,6427,62.39302940718843,Biden
SOUTH CAROLINA,BARNWELL,45011,5492,4720,10212,46.22013317665491,Trump
SOUTH CAROLINA,BEAUFORT,45013,53194,43419,96613,44.94115698715494,Trump
SOUTH CAROLINA,BERKELEY,45015,57397,45223,102620,44.068407717793804,Trump
SOUTH CAROLINA,CALHOUN,45017,4305,3905,8210,47.56394640682095,Trump
SOUTH CAROLINA,CHARLESTON,45019,93297,121485,214782,56.562002402435965,Biden
SOUTH CAROLINA,CHEROKEE,45021,18043,6983,25026,27.902980899864144,Trump
SOUTH CAROLINA,CHESTER,45023,8660,6941,15601,44.490737773219664,Trump
SOUTH CAROLINA,CHESTERFIELD,45025,11297,7431,18728,39.678556172575824,Trump
SOUTH CAROLINA,CLARENDON,45027,8361,8250,16611,49.66588405273614,Trump
SOUTH CAROLINA,COLLETON,45029,10440,8602,19042,45.17382627875223,Trump
SOUTH CAROLINA,DARLINGTON,45031,16832,15220,32052,47.485336328466246,Trump
SOUTH CAROLINA,DILLON,45033,6582,6436,13018,49.43923797818405,Trump
SOUTH CAROLINA,DORCHESTER,45035,41913,33824,75737,44.659809604288526,Trump
SOUTH CAROLINA,EDGEFIELD,45037,8184,4953,13137,37.7026718428865,Trump
SOUTH CAROLINA,FAIRFIELD,45039,4625,7382,12007,61.48080286499542,Biden
SOUTH CAROLINA,FLORENCE,45041,32615,31153,63768,48.8536570066491,Trump
SOUTH CAROLINA,GEORGETOWN,45043,20487,15822,36309,43.57597289928117,Trump
SOUTH CAROLINA,GREENVILLE,45045,150021,103030,253051,40.71511276383021,Trump
SOUTH CAROLINA,GREENWOOD,45047,19431,12145,31576,38.46275652394223,Trump
SOUTH CAROLINA,HAMPTON,45049,3906,5323,9229,57.67688807021346,Biden
SOUTH CAROLINA,HORRY,45051,118821,59180,178001,33.247004230313316,Trump
SOUTH CAROLINA,JASPER,45053,7078,7185,14263,50.37509640328122,Biden
SOUTH CAROLINA,KERSHAW,45055,20471,12699,33170,38.284594513114264,Trump
SOUTH CAROLINA,LANCASTER,45057,30312,18937,49249,38.45154216329266,Trump
SOUTH CAROLINA,LAURENS,45059,20004,10159,30163,33.68033683652157,Trump
SOUTH CAROLINA,LEE,45061,3008,5329,8337,63.91987525488785,Biden
SOUTH CAROLINA,LEXINGTON,45063,92817,49301,142118,34.690187027681226,Trump
SOUTH CAROLINA,MARION,45067,5711,8872,14583,60.83796201056024,Biden
SOUTH CAROLINA,MARLBORO,45069,5044,6290,11334,55.49673548614788,Biden
SOUTH CAROLINA,MCCORMICK,45065,2958,2687,5645,47.599645704162974,Trump
SOUTH CAROLINA,NEWBERRY,45071,11443,6958,18401,37.81316232813434,Trump
SOUTH CAROLINA,OCONEE,45073,29698,10414,40112,25.962305544475466,Trump
SOUTH CAROLINA,ORANGEBURG,45075,13603,27295,40898,66.73920485109296,Biden
SOUTH CAROLINA,PICKENS,45077,42907,13645,56552,24.128235959824586,Trump
SOUTH CAROLINA,RICHLAND,45079,58313,132570,190883,69.45092019718886,Biden
SOUTH CAROLINA,SALUDA,45081,6210,2963,9173,32.301319088629675,Trump
SOUTH CAROLINA,SPARTANBURG,45083,93560,52926,146486,36.13041519326079,Trump
SOUTH CAROLINA,SUMTER,45085,21000,27379,48379,56.592736517910666,Biden
SOUTH CAROLINA,UNION,45087,8183,4935,13118,37.62006403415155,Trump
SOUTH CAROLINA,WILLIAMSBURG,45089,5532,10289,15821,65.03381581442386,Biden
SOUTH CAROLINA,YORK,45091,82727,59008,141735,41.6326242635905,Trump
SOUTH DAKOTA,AURORA,46003,1052,317,1369,23.155588020452885,Trump
SOUTH DAKOTA,BEADLE,46005,4808,2107,6915,30.469992769342007,Trump
SOUTH DAKOTA,BENNETT,46007,694,466,1160,40.17241379310345,Trump
SOUTH DAKOTA,BON HOMME,46009,2235,721,2956,24.39106901217862,Trump
SOUTH DAKOTA,BROOKINGS,46011,8000,6110,14110,43.30262225372076,Trump
SOUTH DAKOTA,BROWN,46013,10580,6538,17118,38.19371421895082,Trump
SOUTH DAKOTA,BRULE,46015,1750,673,2423,27.775484936029716,Trump
SOUTH DAKOTA,BUFFALO,46017,183,352,535,65.7943925233645,Biden
SOUTH DAKOTA,BUTTE,46019,3731,939,4670,20.107066381156315,Trump
SOUTH DAKOTA,CAMPBELL,46021,747,117,864,13.541666666666666,Trump
SOUTH DAKOTA,CHARLES MIX,46023,2552,1177,3729,31.563421828908556,Trump
SOUTH DAKOTA,CLARK,46025,1373,437,1810,24.14364640883978,Trump
SOUTH DAKOTA,CLAY,46027,2456,3083,5539,55.6598664018776,Biden
SOUTH DAKOTA,CODINGTON,46029,8958,3837,12795,29.988276670574443,Trump
SOUTH DAKOTA,CORSON,46031,647,622,1269,49.01497241922774,Trump
SOUTH DAKOTA,CUSTER,46033,3852,1522,5374,28.321548195013023,Trump
SOUTH DAKOTA,DAVISON,46035,5613,2648,8261,32.0542307226728,Trump
SOUTH DAKOTA,DAY,46037,1869,1052,2921,36.0150633344745,Trump
SOUTH DAKOTA,DEUEL,46039,1699,609,2308,26.386481802426342,Trump
SOUTH DAKOTA,DEWEY,46041,790,1131,1921,58.87558563248309,Biden
SOUTH DAKOTA,DOUGLAS,46043,1468,216,1684,12.826603325415679,Trump
SOUTH DAKOTA,EDMUNDS,46045,1538,417,1955,21.32992327365729,Trump
SOUTH DAKOTA,FALL RIVER,46047,2878,1053,3931,26.787077079623504,Trump
SOUTH DAKOTA,FAULK,46049,964,198,1162,17.03958691910499,Trump
SOUTH DAKOTA,GRANT,46051,2618,1056,3674,28.74251497005988,Trump
SOUTH DAKOTA,GREGORY,46053,1771,455,2226,20.440251572327046,Trump
SOUTH DAKOTA,HAAKON,46055,1026,105,1131,9.283819628647215,Trump
SOUTH DAKOTA,HAMLIN,46057,2372,647,3019,21.430937396488904,Trump
SOUTH DAKOTA,HAND,46059,1433,373,1806,20.653377630121817,Trump
SOUTH DAKOTA,HANSON,46061,1793,557,2350,23.70212765957447,Trump
SOUTH DAKOTA,HARDING,46063,748,49,797,6.148055207026349,Trump
SOUTH DAKOTA,HUGHES,46065,5522,2953,8475,34.84365781710915,Trump
SOUTH DAKOTA,HUTCHINSON,46067,2944,762,3706,20.561252023745276,Trump
SOUTH DAKOTA,HYDE,46069,564,136,700,19.428571428571427,Trump
SOUTH DAKOTA,JACKSON,46071,738,359,1097,32.72561531449407,Trump
SOUTH DAKOTA,JERAULD,46073,721,270,991,27.2452068617558,Trump
SOUTH DAKOTA,JONES,46075,498,90,588,15.306122448979592,Trump
SOUTH DAKOTA,KINGSBURY,46077,1904,819,2723,30.077120822622106,Trump
SOUTH DAKOTA,LAKE,46079,3681,2068,5749,35.9714732997043,Trump
SOUTH DAKOTA,LAWRENCE,46081,8753,4537,13290,34.13844996237773,Trump
SOUTH DAKOTA,LINCOLN,46083,19617,11981,31598,37.91695676941579,Trump
SOUTH DAKOTA,LYMAN,46085,1042,525,1567,33.503509891512444,Trump
SOUTH DAKOTA,MARSHALL,46091,1287,858,2145,40,Trump
SOUTH DAKOTA,MCCOOK,46087,2068,769,2837,27.106097990835387,Trump
SOUTH DAKOTA,MCPHERSON,46089,1075,222,1297,17.116422513492676,Trump
SOUTH DAKOTA,MEADE,46093,9875,3285,13160,24.962006079027354,Trump
SOUTH DAKOTA,MELLETTE,46095,449,298,747,39.892904953145916,Trump
SOUTH DAKOTA,MINER,46097,787,320,1107,28.906955736224027,Trump
SOUTH DAKOTA,MINNEHAHA,46099,49249,40482,89731,45.11484325372502,Trump
SOUTH DAKOTA,MOODY,46101,1951,1179,3130,37.66773162939297,Trump
SOUTH DAKOTA,OGLALA LAKOTA,46113,297,2829,3126,90.49904030710174,Biden
SOUTH DAKOTA,PENNINGTON,46103,35063,20606,55669,37.01521493111068,Trump
SOUTH DAKOTA,PERKINS,46105,1401,239,1640,14.573170731707316,Trump
SOUTH DAKOTA,POTTER,46107,1139,227,1366,16.617862371888727,Trump
SOUTH DAKOTA,ROBERTS,46109,2404,1828,4232,43.194706994328925,Trump
SOUTH DAKOTA,SANBORN,46111,905,257,1162,22.117039586919105,Trump
SOUTH DAKOTA,SPINK,46115,2104,998,3102,32.17279174725983,Trump
SOUTH DAKOTA,STANLEY,46117,1203,421,1624,25.923645320197043,Trump
SOUTH DAKOTA,SULLY,46119,726,185,911,20.30735455543359,Trump
SOUTH DAKOTA,TODD,46121,532,1963,2495,78.67735470941884,Biden
SOUTH DAKOTA,TRIPP,46123,2161,495,2656,18.637048192771086,Trump
SOUTH DAKOTA,TURNER,46125,3290,1139,4429,25.716866109731317,Trump
SOUTH DAKOTA,UNION,46127,5944,2725,8669,31.433844734110046,Trump
SOUTH DAKOTA,WALWORTH,46129,1966,565,2531,22.323192414065588,Trump
SOUTH DAKOTA,YANKTON,46135,6581,4016,10597,37.89751816551855,Trump
SOUTH DAKOTA,ZIEBACH,46137,404,481,885,54.35028248587571,Biden
TENNESSEE,ANDERSON,47001,23184,11741,34925,33.61775232641374,Trump
TENNESSEE,BEDFORD,47003,14354,4453,18807,23.67735417663636,Trump
TENNESSEE,BENTON,47005,5668,1529,7197,21.244963179102403,Trump
TENNESSEE,BLEDSOE,47007,4725,971,5696,17.047050561797754,Trump
TENNESSEE,BLOUNT,47009,47369,17932,65301,27.460528935238358,Trump
TENNESSEE,BRADLEY,47011,35204,9851,45055,21.864387970258573,Trump
TENNESSEE,CAMPBELL,47013,12331,2441,14772,16.524505821825073,Trump
TENNESSEE,CANNON,47015,5190,1261,6451,19.547356998914896,Trump
TENNESSEE,CARROLL,47017,9205,2559,11764,21.7528051683101,Trump
TENNESSEE,CARTER,47019,19584,4529,24113,18.78239953552026,Trump
TENNESSEE,CHEATHAM,47021,14438,5514,19952,27.636327185244586,Trump
TENNESSEE,CHESTER,47023,5952,1412,7364,19.17436175991309,Trump
TENNESSEE,CLAIBORNE,47025,10604,2202,12806,17.19506481336873,Trump
TENNESSEE,CLAY,47027,2733,735,3468,21.19377162629758,Trump
TENNESSEE,COCKE,47029,12162,2533,14695,17.23715549506635,Trump
TENNESSEE,COFFEE,47031,17883,5705,23588,24.18602679328472,Trump
TENNESSEE,CROCKETT,47033,4673,1382,6055,22.82411230388109,Trump
TENNESSEE,CUMBERLAND,47035,25168,6728,31896,21.093554050664657,Trump
TENNESSEE,DAVIDSON,47037,100218,199703,299921,66.58520076953597,Biden
TENNESSEE,DECATUR,47039,4229,904,5133,17.611533216442627,Trump
TENNESSEE,DEKALB,47041,6672,1750,8422,20.77891237235811,Trump
TENNESSEE,DICKSON,47043,17643,6106,23749,25.71055623394669,Trump
TENNESSEE,DYER,47045,11768,3158,14926,21.157711376122204,Trump
TENNESSEE,FAYETTE,47047,15690,7027,22717,30.932781617291017,Trump
TENNESSEE,FENTRESS,47049,7441,1214,8655,14.026574234546505,Trump
TENNESSEE,FRANKLIN,47051,13987,4864,18851,25.80234470319877,Trump
TENNESSEE,GIBSON,47053,16259,5771,22030,26.196096232410348,Trump
TENNESSEE,GILES,47055,9784,3298,13082,25.21021250573307,Trump
TENNESSEE,GRAINGER,47057,8565,1467,10032,14.623205741626794,Trump
TENNESSEE,GREENE,47059,22259,5199,27458,18.93437249617598,Trump
TENNESSEE,GRUNDY,47061,4802,988,5790,17.063903281519863,Trump
TENNESSEE,HAMBLEN,47063,18811,5500,24311,22.623503763728355,Trump
TENNESSEE,HAMILTON,47065,92108,75522,167630,45.052794845791325,Trump
TENNESSEE,HANCOCK,47067,2372,362,2734,13.240673006583762,Trump
TENNESSEE,HARDEMAN,47069,5760,4180,9940,42.052313883299796,Trump
TENNESSEE,HARDIN,47071,9559,1775,11334,15.660843479795306,Trump
TENNESSEE,HAWKINS,47073,20405,4083,24488,16.673472721332896,Trump
TENNESSEE,HAYWOOD,47075,3343,4012,7355,54.54792658055745,Biden
TENNESSEE,HENDERSON,47077,9797,2092,11889,17.596097232736145,Trump
TENNESSEE,HENRY,47079,11239,3548,14787,23.994048826672078,Trump
TENNESSEE,HICKMAN,47081,7577,2130,9707,21.942927784073348,Trump
TENNESSEE,HOUSTON,47083,2718,871,3589,24.268598495402617,Trump
TENNESSEE,HUMPHREYS,47085,6120,2017,8137,24.788005407398302,Trump
TENNESSEE,JACKSON,47087,4118,1135,5253,21.606700932800305,Trump
TENNESSEE,JEFFERSON,47089,18651,4654,23305,19.9699635271401,Trump
TENNESSEE,JOHNSON,47091,6468,1246,7714,16.152450090744104,Trump
TENNESSEE,KNOX,47093,124540,91422,215962,42.33244737500116,Trump
TENNESSEE,LAKE,47095,1492,526,2018,26.065411298315162,Trump
TENNESSEE,LAUDERDALE,47097,5674,3193,8867,36.00992443893087,Trump
TENNESSEE,LAWRENCE,47099,15334,3195,18529,17.2432403259755,Trump
TENNESSEE,LEWIS,47101,4474,1072,5546,19.329246303642265,Trump
TENNESSEE,LINCOLN,47103,12281,2919,15200,19.203947368421055,Trump
TENNESSEE,LOUDON,47105,21713,6948,28661,24.242001325843482,Trump
TENNESSEE,MACON,47111,8096,1307,9403,13.89981920663618,Trump
TENNESSEE,MADISON,47113,23943,18390,42333,43.441286939267236,Trump
TENNESSEE,MARION,47115,9911,3177,13088,24.274144254278728,Trump
TENNESSEE,MARSHALL,47117,11043,3605,14648,24.610868377935553,Trump
TENNESSEE,MAURY,47119,31464,14418,45882,31.42408787759906,Trump
TENNESSEE,MCMINN,47107,18198,4361,22559,19.331530652954477,Trump
TENNESSEE,MCNAIRY,47109,9093,1943,11036,17.606016672707504,Trump
TENNESSEE,MEIGS,47121,4467,1008,5475,18.410958904109588,Trump
TENNESSEE,MONROE,47123,16783,3764,20547,18.31897600622962,Trump
TENNESSEE,MONTGOMERY,47125,42187,32472,74659,43.493751590565104,Trump
TENNESSEE,MOORE,47127,2888,573,3461,16.555908696908407,Trump
TENNESSEE,MORGAN,47129,6930,1167,8097,14.412745461281956,Trump
TENNESSEE,OBION,47131,10790,2589,13379,19.35122206442933,Trump
TENNESSEE,OVERTON,47133,7918,2033,9951,20.43010752688172,Trump
TENNESSEE,PERRY,47135,2775,615,3390,18.141592920353983,Trump
TENNESSEE,PICKETT,47137,2381,525,2906,18.066070199587063,Trump
TENNESSEE,POLK,47139,6792,1492,8284,18.010622887493966,Trump
TENNESSEE,PUTNAM,47141,23759,9185,32944,27.88064594463332,Trump
TENNESSEE,RHEA,47143,11050,2369,13419,17.65407258365005,Trump
TENNESSEE,ROANE,47145,19230,6043,25273,23.910893047916748,Trump
TENNESSEE,ROBERTSON,47147,24536,8692,33228,26.158661369928975,Trump
TENNESSEE,RUTHERFORD,47149,81480,59341,140821,42.13931160835387,Trump
TENNESSEE,SCOTT,47151,8004,986,8990,10.967741935483872,Trump
TENNESSEE,SEQUATCHIE,47153,5855,1298,7153,18.14623235006291,Trump
TENNESSEE,SEVIER,47155,33783,8721,42504,20.518068887634104,Trump
TENNESSEE,SHELBY,47157,129815,246105,375920,65.46738667801661,Biden
TENNESSEE,SMITH,47159,7136,1802,8938,20.161109867979413,Trump
TENNESSEE,STEWART,47161,4950,1232,6182,19.9288256227758,Trump
TENNESSEE,SULLIVAN,47163,55860,17272,73132,23.617568232784553,Trump
TENNESSEE,SUMNER,47165,63454,27680,91134,30.372857550420264,Trump
TENNESSEE,TIPTON,47167,20070,6837,26907,25.409744676106587,Trump
TENNESSEE,TROUSDALE,47169,2936,1012,3948,25.633232016210737,Trump
TENNESSEE,UNICOI,47171,6599,1615,8214,19.66155344533723,Trump
TENNESSEE,UNION,47173,6803,1249,8052,15.511674118231495,Trump
TENNESSEE,VAN BUREN,47175,2342,544,2886,18.84961884961885,Trump
TENNESSEE,WARREN,47177,11850,3924,15774,24.87637885127425,Trump
TENNESSEE,WASHINGTON,47179,40444,18638,59082,31.54598693341458,Trump
TENNESSEE,WAYNE,47181,5795,820,6615,12.396069538926682,Trump
TENNESSEE,WEAKLEY,47183,10396,3020,13416,22.510435301132976,Trump
TENNESSEE,WHITE,47185,9606,2143,11749,18.23985020001702,Trump
TENNESSEE,WILLIAMSON,47187,86469,50161,136630,36.71302056649345,Trump
TENNESSEE,WILSON,47189,50296,22254,72550,30.67401791867678,Trump
TEXAS,ANDERSON,48001,15110,3955,19065,20.744820351429322,Trump
TEXAS,ANDREWS,48003,4943,850,5793,14.672881063352323,Trump
TEXAS,ANGELINA,48005,25076,9143,34219,26.719074198544668,Trump
TEXAS,ARANSAS,48007,9239,2916,12155,23.990127519539286,Trump
TEXAS,ARCHER,48009,4300,446,4746,9.397387273493468,Trump
TEXAS,ARMSTRONG,48011,1035,75,1110,6.756756756756757,Trump
TEXAS,ATASCOSA,48013,12039,5876,17915,32.799330170248396,Trump
TEXAS,AUSTIN,48015,11447,2951,14398,20.49590220864009,Trump
TEXAS,BAILEY,48017,1434,409,1843,22.192078133478024,Trump
TEXAS,BANDERA,48019,10057,2505,12562,19.941092182773442,Trump
TEXAS,BASTROP,48021,20516,15474,35990,42.99527646568491,Trump
TEXAS,BAYLOR,48023,1494,183,1677,10.912343470483005,Trump
TEXAS,BEE,48025,6006,3288,9294,35.37766300839251,Trump
TEXAS,BELL,48027,67893,57014,124907,45.645159999039286,Trump
TEXAS,BEXAR,48029,308618,448452,757070,59.23520942581268,Biden
TEXAS,BLANCO,48031,5443,1911,7354,25.985858036442757,Trump
TEXAS,BORDEN,48033,397,16,413,3.87409200968523,Trump
TEXAS,BOSQUE,48035,7469,1561,9030,17.286821705426355,Trump
TEXAS,BOWIE,48037,27116,10747,37863,28.383910413860498,Trump
TEXAS,BRAZORIA,48039,90433,62228,152661,40.76221169781411,Trump
TEXAS,BRAZOS,48041,47530,35349,82879,42.65133507884989,Trump
TEXAS,BREWSTER,48043,2461,2258,4719,47.849120576393304,Trump
TEXAS,BRISCOE,48045,639,78,717,10.87866108786611,Trump
TEXAS,BROOKS,48047,998,1470,2468,59.56239870340356,Biden
TEXAS,BROWN,48049,13698,2107,15805,13.331224296108827,Trump
TEXAS,BURLESON,48051,6743,1788,8531,20.95885593717032,Trump
TEXAS,BURNET,48053,18767,5639,24406,23.10497418667541,Trump
TEXAS,CALDWELL,48055,8031,6672,14703,45.37849418486024,Trump
TEXAS,CALHOUN,48057,5641,2148,7789,27.57735267685197,Trump
TEXAS,CALLAHAN,48059,6012,734,6746,10.88052179069078,Trump
TEXAS,CAMERON,48061,49032,64063,113095,56.64529820062779,Biden
TEXAS,CAMP,48063,3626,1394,5020,27.768924302788843,Trump
TEXAS,CARSON,48065,2779,297,3076,9.655396618985696,Trump
TEXAS,CASS,48067,11033,2795,13828,20.212612091408737,Trump
TEXAS,CASTRO,48069,1602,466,2068,22.53384912959381,Trump
TEXAS,CHAMBERS,48071,17353,3997,21350,18.721311475409834,Trump
TEXAS,CHEROKEE,48073,15101,4210,19311,21.801046035938064,Trump
TEXAS,CHILDRESS,48075,1943,310,2253,13.759431868619618,Trump
TEXAS,CLAY,48077,5069,614,5683,10.804152736230863,Trump
TEXAS,COCHRAN,48079,809,177,986,17.951318458417852,Trump
TEXAS,COKE,48081,1586,178,1764,10.090702947845804,Trump
TEXAS,COLEMAN,48083,3641,451,4092,11.021505376344086,Trump
TEXAS,COLLIN,48085,252318,230945,483263,47.78867821455398,Trump
TEXAS,COLLINGSWORTH,48087,1048,155,1203,12.884455527847049,Trump
TEXAS,COLORADO,48089,7472,2420,9892,24.464213505863324,Trump
TEXAS,COMAL,48091,62740,24826,87566,28.35118653358609,Trump
TEXAS,COMANCHE,48093,5177,853,6030,14.145936981757878,Trump
TEXAS,CONCHO,48095,1058,197,1255,15.697211155378485,Trump
TEXAS,COOKE,48097,15596,3210,18806,17.069020525364245,Trump
TEXAS,CORYELL,48099,15438,7565,23003,32.88701473720819,Trump
TEXAS,COTTLE,48101,540,113,653,17.304747320061256,Trump
TEXAS,CRANE,48103,1247,241,1488,16.196236559139784,Trump
TEXAS,CROCKETT,48105,1220,344,1564,21.994884910485936,Trump
TEXAS,CROSBY,48107,1396,527,1923,27.405096203848156,Trump
TEXAS,CULBERSON,48109,415,438,853,51.34818288393904,Biden
TEXAS,DALLAM,48111,1389,197,1586,12.421185372005045,Trump
TEXAS,DALLAS,48113,307076,598576,905652,66.09337803041345,Biden
TEXAS,DAWSON,48115,2951,808,3759,21.495078478318703,Trump
TEXAS,DEAF SMITH,48117,3294,1264,4558,27.73146116717859,Trump
TEXAS,DELTA,48119,2162,403,2565,15.71150097465887,Trump
TEXAS,DENTON,48121,222480,188695,411175,45.891651973004194,Trump
TEXAS,DEWITT,48123,6567,1494,8061,18.533680684778563,Trump
TEXAS,DICKENS,48125,853,130,983,13.224821973550355,Trump
TEXAS,DIMMIT,48127,1384,2264,3648,62.06140350877193,Biden
TEXAS,DONLEY,48129,1438,198,1636,12.102689486552567,Trump
TEXAS,DUVAL,48131,2443,2575,5018,51.31526504583499,Biden
TEXAS,EASTLAND,48133,7237,983,8220,11.958637469586375,Trump
TEXAS,ECTOR,48135,32697,11367,44064,25.796568627450984,Trump
TEXAS,EDWARDS,48137,893,168,1061,15.83411875589067,Trump
TEXAS,EL PASO,48141,84331,178126,262457,67.8686413393432,Biden
TEXAS,ELLIS,48139,56717,27565,84282,32.705678555326166,Trump
TEXAS,ERATH,48143,13684,2916,16600,17.566265060240962,Trump
TEXAS,FALLS,48145,4177,1899,6076,31.254114549045426,Trump
TEXAS,FANNIN,48147,12171,2655,14826,17.907729664103602,Trump
TEXAS,FAYETTE,48149,10171,2661,12832,20.737219451371573,Trump
TEXAS,FISHER,48151,1448,352,1800,19.555555555555557,Trump
TEXAS,FLOYD,48153,1584,438,2022,21.66172106824926,Trump
TEXAS,FOARD,48155,445,99,544,18.198529411764707,Trump
TEXAS,FORT BEND,48157,157718,195552,353270,55.35482775214425,Biden
TEXAS,FRANKLIN,48159,4161,804,4965,16.19335347432024,Trump
TEXAS,FREESTONE,48161,6991,1635,8626,18.95432413633202,Trump
TEXAS,FRIO,48163,2823,2422,5245,46.17731172545281,Trump
TEXAS,GAINES,48165,5355,576,5931,9.711684370257966,Trump
TEXAS,GALVESTON,48167,93911,58842,152753,38.521011043972955,Trump
TEXAS,GARZA,48169,1413,231,1644,14.051094890510948,Trump
TEXAS,GILLESPIE,48171,12514,3176,15690,20.24219247928617,Trump
TEXAS,GLASSCOCK,48173,611,39,650,6,Trump
TEXAS,GOLIAD,48175,3085,877,3962,22.135285209490156,Trump
TEXAS,GONZALES,48177,5627,1948,7575,25.716171617161717,Trump
TEXAS,GRAY,48179,6840,829,7669,10.809753553266397,Trump
TEXAS,GRAYSON,48181,44163,14506,58669,24.725152976870238,Trump
TEXAS,GREGG,48183,32493,14796,47289,31.288460318467298,Trump
TEXAS,GRIMES,48185,9432,2833,12265,23.098247044435386,Trump
TEXAS,GUADALUPE,48187,47553,28805,76358,37.72361769559181,Trump
TEXAS,HALE,48189,7177,2279,9456,24.10109983079526,Trump
TEXAS,HALL,48191,995,168,1163,14.445399828030956,Trump
TEXAS,HAMILTON,48193,3616,641,4257,15.057552266854593,Trump
TEXAS,HANSFORD,48195,1849,166,2015,8.23821339950372,Trump
TEXAS,HARDEMAN,48197,1330,241,1571,15.340547422024189,Trump
TEXAS,HARDIN,48199,23858,3474,27332,12.710376115908092,Trump
TEXAS,HARRIS,48201,700630,918193,1618823,56.7197896249312,Biden
TEXAS,HARRISON,48203,21466,7908,29374,26.921767549533598,Trump
TEXAS,HARTLEY,48205,1868,195,2063,9.452253999030539,Trump
TEXAS,HASKELL,48207,1840,353,2193,16.09667122663019,Trump
TEXAS,HAYS,48209,47680,59524,107204,55.5240476101638,Biden
TEXAS,HEMPHILL,48211,1486,206,1692,12.174940898345152,Trump
TEXAS,HENDERSON,48213,28911,7060,35971,19.626921686914457,Trump
TEXAS,HIDALGO,48215,90527,128199,218726,58.611687682305714,Biden
TEXAS,HILL,48217,11926,2860,14786,19.342621398620317,Trump
TEXAS,HOCKLEY,48219,6536,1482,8018,18.48341232227488,Trump
TEXAS,HOOD,48221,26496,5648,32144,17.57093081134893,Trump
TEXAS,HOPKINS,48223,12719,3046,15765,19.321281319378368,Trump
TEXAS,HOUSTON,48225,7060,2314,9374,24.6852997653083,Trump
TEXAS,HOWARD,48227,8054,2069,10123,20.438605156574138,Trump
TEXAS,HUDSPETH,48229,779,371,1150,32.26086956521739,Trump
TEXAS,HUNT,48231,29163,8906,38069,23.394362867424938,Trump
TEXAS,HUTCHINSON,48233,7681,965,8646,11.161230626879481,Trump
TEXAS,IRION,48235,759,120,879,13.651877133105803,Trump
TEXAS,JACK,48237,3418,331,3749,8.829021072285943,Trump
TEXAS,JACKSON,48239,5231,1033,6264,16.491060025542783,Trump
TEXAS,JASPER,48241,12542,2954,15496,19.062983995869903,Trump
TEXAS,JEFF DAVIS,48243,784,501,1285,38.98832684824903,Trump
TEXAS,JEFFERSON,48245,47570,46073,93643,49.2006877182491,Trump
TEXAS,JIM HOGG,48247,833,1197,2030,58.9655172413793,Biden
TEXAS,JIM WELLS,48249,7453,6119,13572,45.085470085470085,Trump
TEXAS,JOHNSON,48251,54628,16464,71092,23.158723907050017,Trump
TEXAS,JONES,48253,5660,999,6659,15.002252590479051,Trump
TEXAS,KARNES,48255,3968,1234,5202,23.72164552095348,Trump
TEXAS,KAUFMAN,48257,37624,18405,56029,32.84906030805475,Trump
TEXAS,KENDALL,48259,20083,6020,26103,23.06248323947439,Trump
TEXAS,KENEDY,48261,127,65,192,33.85416666666667,Trump
TEXAS,KENT,48263,411,47,458,10.262008733624455,Trump
TEXAS,KERR,48265,20879,6524,27403,23.807612305222055,Trump
TEXAS,KIMBLE,48267,1987,284,2271,12.505504183179216,Trump
TEXAS,KING,48269,151,8,159,5.031446540880504,Trump
TEXAS,KINNEY,48271,1144,446,1590,28.050314465408803,Trump
TEXAS,KLEBERG,48273,5504,5314,10818,49.12183398040303,Trump
TEXAS,KNOX,48275,1180,265,1445,18.33910034602076,Trump
TEXAS,LA SALLE,48283,1335,1052,2387,44.07205697528278,Trump
TEXAS,LAMAR,48277,16760,4458,21218,21.010462814591385,Trump
TEXAS,LAMB,48279,3521,840,4361,19.26163723916533,Trump
TEXAS,LAMPASAS,48281,8086,2144,10230,20.95796676441838,Trump
TEXAS,LAVACA,48285,8804,1333,10137,13.149847094801222,Trump
TEXAS,LEE,48287,6255,1750,8005,21.861336664584634,Trump
TEXAS,LEON,48289,7523,1072,8595,12.472367655613729,Trump
TEXAS,LIBERTY,48291,23302,5785,29087,19.888610031973048,Trump
TEXAS,LIMESTONE,48293,6789,2213,9002,24.583425905354368,Trump
TEXAS,LIPSCOMB,48295,1205,131,1336,9.805389221556887,Trump
TEXAS,LIVE OAK,48297,4199,819,5018,16.321243523316063,Trump
TEXAS,LLANO,48299,10079,2465,12544,19.650829081632654,Trump
TEXAS,LOVING,48301,60,4,64,6.25,Trump
TEXAS,LUBBOCK,48303,78861,40017,118878,33.662241962347956,Trump
TEXAS,LYNN,48305,1853,428,2281,18.76370013152126,Trump
TEXAS,MADISON,48313,4169,1088,5257,20.696214571048127,Trump
TEXAS,MARION,48315,3470,1339,4809,27.843626533582867,Trump
TEXAS,MARTIN,48317,1857,288,2145,13.426573426573427,Trump
TEXAS,MASON,48319,1991,457,2448,18.66830065359477,Trump
TEXAS,MATAGORDA,48321,9845,3733,13578,27.49300338783326,Trump
TEXAS,MAVERICK,48323,6881,8332,15213,54.7689476105962,Biden
TEXAS,MCCULLOCH,48307,2904,490,3394,14.437242192103714,Trump
TEXAS,MCLENNAN,48309,59543,36688,96231,38.1249285573256,Trump
TEXAS,MCMULLEN,48311,460,53,513,10.33138401559454,Trump
TEXAS,MEDINA,48325,15642,6773,22415,30.216372964532678,Trump
TEXAS,MENARD,48327,823,197,1020,19.31372549019608,Trump
TEXAS,MIDLAND,48329,45624,12329,57953,21.274135937742653,Trump
TEXAS,MILAM,48331,7984,2496,10480,23.81679389312977,Trump
TEXAS,MILLS,48333,2217,271,2488,10.892282958199356,Trump
TEXAS,MITCHELL,48335,2170,397,2567,15.465523957927541,Trump
TEXAS,MONTAGUE,48337,8615,1097,9712,11.295304777594728,Trump
TEXAS,MONTGOMERY,48339,193382,74377,267759,27.777591042691373,Trump
TEXAS,MOORE,48341,4359,1062,5421,19.590481460985057,Trump
TEXAS,MORRIS,48343,3872,1669,5541,30.1209168020213,Trump
TEXAS,MOTLEY,48345,604,46,650,7.076923076923077,Trump
TEXAS,NACOGDOCHES,48347,17378,9000,26378,34.119341875805596,Trump
TEXAS,NAVARRO,48349,13800,5101,18901,26.987990053436327,Trump
TEXAS,NEWTON,48351,4882,1173,6055,19.372419488026424,Trump
TEXAS,NOLAN,48353,4131,1162,5293,21.953523521632345,Trump
TEXAS,NUECES,48355,64617,60925,125542,48.52957575950678,Trump
TEXAS,OCHILTREE,48357,2812,302,3114,9.698137443802183,Trump
TEXAS,OLDHAM,48359,917,81,998,8.11623246492986,Trump
TEXAS,ORANGE,48361,29186,6357,35543,17.885378274203077,Trump
TEXAS,PALO PINTO,48363,10179,2178,12357,17.625637290604516,Trump
TEXAS,PANOLA,48365,9326,2057,11383,18.07080734428534,Trump
TEXAS,PARKER,48367,62045,13017,75062,17.341664224241292,Trump
TEXAS,PARMER,48369,2135,488,2623,18.6046511627907,Trump
TEXAS,PECOS,48371,3215,1382,4597,30.063084620404613,Trump
TEXAS,POLK,48373,18573,5387,23960,22.48330550918197,Trump
TEXAS,POTTER,48375,22820,9921,32741,30.30145688891604,Trump
TEXAS,PRESIDIO,48377,721,1463,2184,66.98717948717949,Biden
TEXAS,RAINS,48379,5155,842,5997,14.040353510088377,Trump
TEXAS,RANDALL,48381,50796,12802,63598,20.129563822761725,Trump
TEXAS,REAGAN,48383,942,172,1114,15.439856373429084,Trump
TEXAS,REAL,48385,1643,320,1963,16.301579215486502,Trump
TEXAS,RED RIVER,48387,4517,1246,5763,21.620683671698767,Trump
TEXAS,REEVES,48389,2254,1395,3649,38.22965195944094,Trump
TEXAS,REFUGIO,48391,2210,1108,3318,33.393610608800486,Trump
TEXAS,ROBERTS,48393,529,17,546,3.1135531135531136,Trump
TEXAS,ROBERTSON,48395,5646,2374,8020,29.600997506234418,Trump
TEXAS,ROCKWALL,48397,36726,16412,53138,30.885618578042077,Trump
TEXAS,RUNNELS,48399,3807,552,4359,12.663454920853406,Trump
TEXAS,RUSK,48401,16534,4629,21163,21.873080376128147,Trump
TEXAS,SABINE,48403,4784,669,5453,12.268476068219329,Trump
TEXAS,SAN AUGUSTINE,48405,3007,980,3987,24.57988462503135,Trump
TEXAS,SAN JACINTO,48407,10161,2337,12498,18.69899183869419,Trump
TEXAS,SAN PATRICIO,48409,16516,8988,25504,35.24153074027603,Trump
TEXAS,SAN SABA,48411,2308,287,2595,11.059730250481696,Trump
TEXAS,SCHLEICHER,48413,940,211,1151,18.33188531711555,Trump
TEXAS,SCURRY,48415,4983,818,5801,14.1010170660231,Trump
TEXAS,SHACKELFORD,48417,1484,130,1614,8.054522924411401,Trump
TEXAS,SHELBY,48419,7975,2068,10043,20.59145673603505,Trump
TEXAS,SHERMAN,48421,886,91,977,9.31422722620266,Trump
TEXAS,SMITH,48423,69080,29615,98695,30.00658594660317,Trump
TEXAS,SOMERVELL,48425,4105,768,4873,15.76031192284014,Trump
TEXAS,STARR,48427,8247,9123,17370,52.52158894645941,Biden
TEXAS,STEPHENS,48429,3385,397,3782,10.497091485986251,Trump
TEXAS,STERLING,48431,584,51,635,8.031496062992126,Trump
TEXAS,STONEWALL,48433,615,116,731,15.868673050615595,Trump
TEXAS,SUTTON,48435,1222,322,1544,20.854922279792746,Trump
TEXAS,SWISHER,48437,1845,478,2323,20.576840292724924,Trump
TEXAS,TARRANT,48439,409741,411567,821308,50.11116414304987,Biden
TEXAS,TAYLOR,48441,39547,14588,54135,26.94744619931652,Trump
TEXAS,TERRELL,48443,334,119,453,26.269315673289185,Trump
TEXAS,TERRY,48445,2812,757,3569,21.21042308769964,Trump
TEXAS,THROCKMORTON,48447,806,82,888,9.234234234234235,Trump
TEXAS,TITUS,48449,7570,2856,10426,27.393055821983502,Trump
TEXAS,TOM GREEN,48451,32313,12239,44552,27.471269527742866,Trump
TEXAS,TRAVIS,48453,161337,435860,597197,72.9842916156645,Biden
TEXAS,TRINITY,48455,5579,1323,6902,19.168356997971603,Trump
TEXAS,TYLER,48457,8194,1403,9597,14.619151818276544,Trump
TEXAS,UPSHUR,48459,15809,2877,18686,15.396553569517286,Trump
TEXAS,UPTON,48461,1178,170,1348,12.611275964391691,Trump
TEXAS,UVALDE,48463,6174,4073,10247,39.74821899092417,Trump
TEXAS,VAL VERDE,48465,8284,6771,15055,44.97509133178346,Trump
TEXAS,VAN ZANDT,48467,22270,3516,25786,13.63530597998914,Trump
TEXAS,VICTORIA,48469,23358,10380,33738,30.7664947536902,Trump
TEXAS,WALKER,48471,15375,7884,23259,33.89655617180446,Trump
TEXAS,WALLER,48473,14260,8191,22451,36.48389826733776,Trump
TEXAS,WARD,48475,3241,764,4005,19.076154806491886,Trump
TEXAS,WASHINGTON,48477,12959,4261,17220,24.744483159117305,Trump
TEXAS,WEBB,48479,25898,41820,67718,61.75610620514487,Biden
TEXAS,WHARTON,48481,11926,4694,16620,28.243080625752103,Trump
TEXAS,WHEELER,48483,2159,168,2327,7.219596046411689,Trump
TEXAS,WICHITA,48485,32069,13161,45230,29.097943842582357,Trump
TEXAS,WILBARGER,48487,3524,956,4480,21.33928571428571,Trump
TEXAS,WILLACY,48489,2441,3108,5549,56.010091908451976,Biden
TEXAS,WILLIAMSON,48491,139729,143795,283524,50.71704688139276,Biden
TEXAS,WILSON,48493,18463,6350,24813,25.591423850401,Trump
TEXAS,WINKLER,48495,1753,358,2111,16.95878730459498,Trump
TEXAS,WISE,48497,27032,4973,32005,15.538197156694267,Trump
TEXAS,WOOD,48499,19049,3509,22558,15.55545704406419,Trump
TEXAS,YOAKUM,48501,2174,420,2594,16.191210485736317,Trump
TEXAS,YOUNG,48503,7110,1034,8144,12.696463654223969,Trump
TEXAS,ZAPATA,48505,2033,1826,3859,47.317958020212494,Trump
TEXAS,ZAVALA,48507,1490,2864,4354,65.77859439595774,Biden
UTAH,BEAVER,49001,2695,357,3052,11.697247706422019,Trump
UTAH,BOX ELDER,49003,21548,4473,26021,17.18996195380654,Trump
UTAH,CACHE,49005,38032,16650,54682,30.448776562671448,Trump
UTAH,CARBON,49007,6693,2392,9085,26.329113924050635,Trump
UTAH,DAGGETT,49009,496,111,607,18.28665568369028,Trump
UTAH,DAVIS,49011,104135,57411,161546,35.538484394537775,Trump
UTAH,DUCHESNE,49013,7512,843,8355,10.089766606822263,Trump
UTAH,EMERY,49015,4207,572,4779,11.969031178070725,Trump
UTAH,GARFIELD,49017,2158,514,2672,19.236526946107784,Trump
UTAH,GRAND,49019,2248,2806,5054,55.52037989711119,Biden
UTAH,IRON,49021,18989,4892,23881,20.484904317239646,Trump
UTAH,JUAB,49023,5087,645,5732,11.25261688764829,Trump
UTAH,KANE,49025,2998,1083,4081,26.53761333006616,Trump
UTAH,MILLARD,49027,5404,624,6028,10.351692103516921,Trump
UTAH,MORGAN,49029,5181,1086,6267,17.32886548587841,Trump
UTAH,PIUTE,49031,773,86,859,10.011641443538998,Trump
UTAH,RICH,49033,1157,180,1337,13.462976813762154,Trump
UTAH,SALT LAKE,49035,230174,289906,520080,55.7425780649131,Biden
UTAH,SAN JUAN,49037,3535,3113,6648,46.82611311672684,Trump
UTAH,SANPETE,49039,10459,1794,12253,14.641312331673875,Trump
UTAH,SEVIER,49041,9052,1084,10136,10.69455406471981,Trump
UTAH,SUMMIT,49043,10252,15244,25496,59.78977094446187,Biden
UTAH,TOOELE,49045,21014,8943,29957,29.852788997563174,Trump
UTAH,UINTAH,49047,13261,1663,14924,11.14312516751541,Trump
UTAH,UTAH,49049,192812,76033,268845,28.28135170823337,Trump
UTAH,WASATCH,49051,10795,6187,16982,36.43269344011306,Trump
UTAH,WASHINGTON,49053,67294,20530,87824,23.37629805064675,Trump
UTAH,WAYNE,49055,1229,365,1594,22.898368883312422,Trump
UTAH,WEBER,49057,65949,40695,106644,38.15967143017892,Trump
VERMONT,ADDISON,50001,6567,15089,21656,69.67584041374215,Biden
VERMONT,BENNINGTON,50003,6724,11858,18582,63.8144440856743,Biden
VERMONT,CALEDONIA,50005,5924,8529,14453,59.01196983325261,Biden
VERMONT,CHITTENDEN,50007,20104,72938,93042,78.39255390038907,Biden
VERMONT,ESSEX,50009,2164,1890,4054,46.62062160828811,Trump
VERMONT,FRANKLIN,50011,11274,13612,24886,54.69742023627743,Biden
VERMONT,GRAND ISLE,50013,2194,3346,5540,60.397111913357406,Biden
VERMONT,LAMOILLE,50015,4171,10773,14944,72.08913276231263,Biden
VERMONT,ORANGE,50017,5782,8351,14133,59.088657751362064,Biden
VERMONT,ORLEANS,50019,7086,7757,14843,52.26032473219699,Biden
VERMONT,RUTLAND,50021,14625,18746,33371,56.17452278924815,Biden
VERMONT,WASHINGTON,50023,8707,25101,33808,74.24574065309986,Biden
VERMONT,WINDHAM,50025,7251,20057,27308,73.44734143840633,Biden
VERMONT,WINDSOR,50027,10135,24779,34914,70.97153004525406,Biden
VIRGINIA,ACCOMACK,51001,9172,7578,16750,45.24179104477612,Trump
VIRGINIA,ALBEMARLE,51003,20804,42466,63270,67.11869764501344,Biden
VIRGINIA,ALEXANDRIA CITY,51510,14544,66240,80784,81.99643493761141,Biden
VIRGINIA,ALLEGHANY,51005,5859,2243,8102,27.68452234016292,Trump
VIRGINIA,AMELIA,51007,5390,2411,7801,30.906294064863477,Trump
VIRGINIA,AMHERST,51009,11041,5672,16713,33.937653323759946,Trump
VIRGINIA,APPOMATTOX,51011,6702,2418,9120,26.513157894736842,Trump
VIRGINIA,ARLINGTON,51013,22318,105344,127662,82.51789882658896,Biden
VIRGINIA,AUGUSTA,51015,30714,10840,41554,26.086537998748614,Trump
VIRGINIA,BATH,51017,1834,646,2480,26.048387096774196,Trump
VIRGINIA,BEDFORD,51019,35600,12176,47776,25.485599464166107,Trump
VIRGINIA,BLAND,51021,2903,532,3435,15.487627365356623,Trump
VIRGINIA,BOTETOURT,51023,15099,5700,20799,27.40516370979374,Trump
VIRGINIA,BRISTOL CITY,51520,5347,2313,7660,30.195822454308097,Trump
VIRGINIA,BRUNSWICK,51025,3357,4552,7909,57.55468453660387,Biden
VIRGINIA,BUCHANAN,51027,8311,1587,9898,16.033542129723177,Trump
VIRGINIA,BUCKINGHAM,51029,4544,3471,8015,43.30630068621335,Trump
VIRGINIA,BUENA VISTA CITY,51530,1863,825,2688,30.691964285714285,Trump
VIRGINIA,CAMPBELL,51031,21245,8070,29315,27.528568991983626,Trump
VIRGINIA,CAROLINE,51033,8336,7657,15993,47.8771962733696,Trump
VIRGINIA,CARROLL,51035,12659,2842,15501,18.33430101283788,Trump
VIRGINIA,CHARLES CITY,51036,1761,2624,4385,59.840364880273654,Biden
VIRGINIA,CHARLOTTE,51037,3815,2317,6132,37.78538812785388,Trump
VIRGINIA,CHARLOTTESVILLE CITY,51540,3094,20696,23790,86.99453551912568,Biden
VIRGINIA,CHESAPEAKE CITY,51550,58180,66377,124557,53.29046139518453,Biden
VIRGINIA,CHESTERFIELD,51041,93326,106935,200261,53.39781585031533,Biden
VIRGINIA,CLARKE,51043,5192,3920,9112,43.02019315188762,Trump
VIRGINIA,COLONIAL HEIGHTS CITY,51570,6007,2972,8979,33.099454282214055,Trump
VIRGINIA,COVINGTON CITY,51580,1580,964,2544,37.89308176100629,Trump
VIRGINIA,CRAIG,51045,2536,587,3123,18.796029458853667,Trump
VIRGINIA,CULPEPER,51047,16012,10617,26629,39.8700664688873,Trump
VIRGINIA,CUMBERLAND,51049,3019,2227,5246,42.45139153640869,Trump
VIRGINIA,DANVILLE CITY,51590,7428,11710,19138,61.18716689309228,Biden
VIRGINIA,DICKENSON,51051,5748,1503,7251,20.72817542407944,Trump
VIRGINIA,DINWIDDIE,51053,8695,6224,14919,41.718613848113144,Trump
VIRGINIA,EMPORIA CITY,51595,754,1612,2366,68.13186813186813,Biden
VIRGINIA,ESSEX,51057,3075,3038,6113,49.69736626860789,Trump
VIRGINIA,FAIRFAX,51059,168401,419943,588344,71.37711950831486,Biden
VIRGINIA,FAIRFAX CITY,51600,4007,9174,13181,69.60018208026705,Biden
VIRGINIA,FALLS CHURCH CITY,51610,1490,7146,8636,82.74664196387216,Biden
VIRGINIA,FAUQUIER,51061,25106,17565,42671,41.16378805277589,Trump
VIRGINIA,FLOYD,51063,6225,3004,9229,32.54957200130025,Trump
VIRGINIA,FLUVANNA,51065,8155,7414,15569,47.62027105144839,Trump
VIRGINIA,FRANKLIN,51067,20895,8381,29276,28.627544746550075,Trump
VIRGINIA,FRANKLIN CITY,51620,1487,2525,4012,62.93619142572283,Biden
VIRGINIA,FREDERICK,51069,30558,17207,47765,36.024285564744055,Trump
VIRGINIA,FREDERICKSBURG CITY,51630,4037,8517,12554,67.84291859168393,Biden
VIRGINIA,GALAX CITY,51640,1838,777,2615,29.713193116634802,Trump
VIRGINIA,GILES,51071,6876,2156,9032,23.87068201948627,Trump
VIRGINIA,GLOUCESTER,51073,14875,6964,21839,31.887906955446677,Trump
VIRGINIA,GOOCHLAND,51075,9966,6685,16651,40.14773887454207,Trump
VIRGINIA,GRAYSON,51077,6529,1535,8064,19.035218253968253,Trump
VIRGINIA,GREENE,51079,6866,4163,11029,37.74594251518724,Trump
VIRGINIA,GREENSVILLE,51081,1914,2627,4541,57.850693679806206,Biden
VIRGINIA,HALIFAX,51083,10418,7666,18084,42.391063923910636,Trump
VIRGINIA,HAMPTON CITY,51650,18430,46220,64650,71.49265274555297,Biden
VIRGINIA,HANOVER,51085,44318,25307,69625,36.347576301615796,Trump
VIRGINIA,HARRISONBURG CITY,51660,5591,11022,16613,66.34563293806055,Biden
VIRGINIA,HENRICO,51087,63440,116572,180012,64.75790502855365,Biden
VIRGINIA,HENRY,51089,16725,9127,25852,35.304812006807985,Trump
VIRGINIA,HIGHLAND,51091,1092,417,1509,27.634194831013914,Trump
VIRGINIA,HOPEWELL CITY,51670,4020,5430,9450,57.460317460317455,Biden
VIRGINIA,ISLE OF WIGHT,51093,13707,9399,23106,40.677746039989614,Trump
VIRGINIA,JAMES CITY,51095,23153,25553,48706,52.46376216482569,Biden
VIRGINIA,KING AND QUEEN,51097,2450,1590,4040,39.35643564356436,Trump
VIRGINIA,KING GEORGE,51099,8446,5404,13850,39.018050541516246,Trump
VIRGINIA,KING WILLIAM,51101,7320,3260,10580,30.812854442344044,Trump
VIRGINIA,LANCASTER,51103,3697,3368,7065,47.67162066525124,Trump
VIRGINIA,LEE,51105,8365,1489,9854,15.110614978688858,Trump
VIRGINIA,LEXINGTON CITY,51678,906,1791,2697,66.40711902113459,Biden
VIRGINIA,LOUDOUN,51107,82088,138372,220460,62.76512746076386,Biden
VIRGINIA,LOUISA,51109,13294,8269,21563,38.34809627602838,Trump
VIRGINIA,LUNENBURG,51111,3537,2418,5955,40.604534005037785,Trump
VIRGINIA,LYNCHBURG CITY,51680,17097,18048,35145,51.35296628254375,Biden
VIRGINIA,MADISON,51113,5300,2698,7998,33.73343335833959,Trump
VIRGINIA,MANASSAS CITY,51683,6256,10356,16612,62.34047676378521,Biden
VIRGINIA,MANASSAS PARK CITY,51685,1979,3992,5971,66.85647295260425,Biden
VIRGINIA,MARTINSVILLE CITY,51690,2165,3766,5931,63.496880795818576,Biden
VIRGINIA,MATHEWS,51115,3901,1825,5726,31.87216206776109,Trump
VIRGINIA,MECKLENBURG,51117,9266,6803,16069,42.33617524425913,Trump
VIRGINIA,MIDDLESEX,51119,4196,2491,6687,37.251383280992975,Trump
VIRGINIA,MONTGOMERY,51121,20629,23218,43847,52.9523114466212,Biden
VIRGINIA,NELSON,51125,4812,4327,9139,47.34653682022103,Trump
VIRGINIA,NEW KENT,51127,9631,4621,14252,32.423519506034246,Trump
VIRGINIA,NEWPORT NEWS CITY,51700,26377,53099,79476,66.81136443706276,Biden
VIRGINIA,NORFOLK CITY,51710,23443,64440,87883,73.3247613304052,Biden
VIRGINIA,NORTHAMPTON,51131,2955,3667,6622,55.3760193295077,Biden
VIRGINIA,NORTHUMBERLAND,51133,4485,3252,7737,42.0317952694843,Trump
VIRGINIA,NORTON CITY,51720,1109,464,1573,29.497774952320405,Trump
VIRGINIA,NOTTOWAY,51135,4027,2971,6998,42.45498713918263,Trump
VIRGINIA,ORANGE,51137,12426,7995,20421,39.15087410019098,Trump
VIRGINIA,PAGE,51139,9345,3007,12352,24.344235751295336,Trump
VIRGINIA,PATRICK,51141,7485,1954,9439,20.701345481512874,Trump
VIRGINIA,PETERSBURG CITY,51730,1584,12389,13973,88.6638517140199,Biden
VIRGINIA,PITTSYLVANIA,51143,23751,10115,33866,29.8677139313766,Trump
VIRGINIA,POQUOSON CITY,51735,5605,2054,7659,26.818122470296384,Trump
VIRGINIA,PORTSMOUTH CITY,51740,12755,30948,43703,70.81436057021257,Biden
VIRGINIA,POWHATAN,51145,14055,5320,19375,27.45806451612903,Trump
VIRGINIA,PRINCE EDWARD,51147,4434,4973,9407,52.864887849473796,Biden
VIRGINIA,PRINCE GEORGE,51149,10103,7103,17206,41.282110891549465,Trump
VIRGINIA,PRINCE WILLIAM,51153,81222,142863,224085,63.75393265948189,Biden
VIRGINIA,PULASKI,51155,12127,4925,17052,28.882242552193294,Trump
VIRGINIA,RADFORD CITY,51750,2786,3358,6144,54.654947916666664,Biden
VIRGINIA,RAPPAHANNOCK,51157,2812,2096,4908,42.70578647106765,Trump
VIRGINIA,RICHMOND,51159,2547,1513,4060,37.26600985221675,Trump
VIRGINIA,RICHMOND CITY,51760,16603,92175,108778,84.73680339774586,Biden
VIRGINIA,ROANOKE,51161,34268,21801,56069,38.88244841177834,Trump
VIRGINIA,ROANOKE CITY,51770,15607,26773,42380,63.173666823973576,Biden
VIRGINIA,ROCKBRIDGE,51163,8088,4086,12174,33.56333169048792,Trump
VIRGINIA,ROCKINGHAM,51165,30349,12644,42993,29.409438745842348,Trump
VIRGINIA,RUSSELL,51167,10879,2373,13252,17.90673105946272,Trump
VIRGINIA,SALEM CITY,51775,7683,5148,12831,40.121580547112465,Trump
VIRGINIA,SCOTT,51169,9063,1692,10755,15.732217573221757,Trump
VIRGINIA,SHENANDOAH,51171,16463,6836,23299,29.34031503498004,Trump
VIRGINIA,SMYTH,51173,10963,3008,13971,21.530312790780904,Trump
VIRGINIA,SOUTHAMPTON,51175,5730,3969,9699,40.92174450974328,Trump
VIRGINIA,SPOTSYLVANIA,51177,39411,34307,73718,46.5381589299764,Trump
VIRGINIA,STAFFORD,51179,37636,40245,77881,51.67499133293101,Biden
VIRGINIA,STAUNTON CITY,51790,5695,6981,12676,55.072578100347116,Biden
VIRGINIA,SUFFOLK CITY,51800,20082,28676,48758,58.812912752779035,Biden
VIRGINIA,SURRY,51181,2025,2397,4422,54.20624151967436,Biden
VIRGINIA,SUSSEX,51183,2219,2827,5046,56.024573919936586,Biden
VIRGINIA,TAZEWELL,51185,16731,3205,19936,16.076444622792938,Trump
VIRGINIA,VIRGINIA BEACH CITY,51810,105087,117393,222480,52.765641855447676,Biden
VIRGINIA,WARREN,51187,14069,6603,20672,31.941756965944272,Trump
VIRGINIA,WASHINGTON,51191,21679,6617,28296,23.384930732258976,Trump
VIRGINIA,WAYNESBORO CITY,51820,5507,4961,10468,47.39205196790218,Trump
VIRGINIA,WESTMORELAND,51193,5318,4501,9819,45.839698543639884,Trump
VIRGINIA,WILLIAMSBURG CITY,51830,1963,4790,6753,70.93143787946097,Biden
VIRGINIA,WINCHESTER CITY,51840,5221,6610,11831,55.87017158312907,Biden
VIRGINIA,WISE,51195,13366,3110,16476,18.87594076232095,Trump
VIRGINIA,WYTHE,51197,11733,3143,14876,21.127991395536437,Trump
VIRGINIA,YORK,51199,20241,17683,37924,46.62746545723025,Trump
WASHINGTON,ADAMS,53001,3907,1814,5721,31.707743401503237,Trump
WASHINGTON,ASOTIN,53003,7319,4250,11569,36.736105108479556,Trump
WASHINGTON,BENTON,53005,60365,38706,99071,39.06895055061522,Trump
WASHINGTON,CHELAN,53007,22746,19349,42095,45.96507898800333,Trump
WASHINGTON,CLALLAM,53009,23062,24721,47783,51.73597304480673,Biden
WASHINGTON,CLARK,53011,126303,140324,266627,52.629328612631134,Biden
WASHINGTON,COLUMBIA,53013,1754,668,2422,27.580511973575554,Trump
WASHINGTON,COWLITZ,53015,34424,23938,58362,41.016414790445836,Trump
WASHINGTON,DOUGLAS,53017,12955,7811,20766,37.614369642685155,Trump
WASHINGTON,FERRY,53019,2771,1486,4257,34.907211651397695,Trump
WASHINGTON,FRANKLIN,53021,18039,13340,31379,42.51250836546735,Trump
WASHINGTON,GARFIELD,53023,1069,366,1435,25.505226480836235,Trump
WASHINGTON,GRANT,53025,24764,11819,36583,32.30735587567996,Trump
WASHINGTON,GRAYS HARBOR,53027,19877,17354,37231,46.61169455561226,Trump
WASHINGTON,ISLAND,53029,22746,29213,51959,56.22317596566524,Biden
WASHINGTON,JEFFERSON,53031,6931,17204,24135,71.28237000207169,Biden
WASHINGTON,KING,53033,269167,907310,1176477,77.12092969093318,Biden
WASHINGTON,KITSAP,53035,61563,90277,151840,59.45534773445732,Biden
WASHINGTON,KITTITAS,53037,14105,11421,25526,44.74261537256131,Trump
WASHINGTON,KLICKITAT,53039,7237,5959,13196,45.15762352227948,Trump
WASHINGTON,LEWIS,53041,29391,14520,43911,33.06688529070165,Trump
WASHINGTON,LINCOLN,53043,5150,1713,6863,24.959930059740635,Trump
WASHINGTON,MASON,53045,18710,17269,35979,47.997442952833595,Trump
WASHINGTON,OKANOGAN,53047,11840,8900,20740,42.912246865959496,Trump
WASHINGTON,PACIFIC,53049,6953,6794,13747,49.42169200552848,Trump
WASHINGTON,PEND OREILLE,53051,5728,2593,8321,31.16211993750751,Trump
WASHINGTON,PIERCE,53053,197730,249506,447236,55.78844279083079,Biden
WASHINGTON,SAN JUAN,53055,3057,9725,12782,76.08355499921765,Biden
WASHINGTON,SKAGIT,53057,32762,38252,71014,53.86543498465092,Biden
WASHINGTON,SKAMANIA,53059,3885,3192,7077,45.103857566765576,Trump
WASHINGTON,SNOHOMISH,53061,166428,256728,423156,60.66982389473385,Biden
WASHINGTON,SPOKANE,53063,148576,135765,284341,47.74724714339473,Trump
WASHINGTON,STEVENS,53065,19808,7839,27647,28.35389011465982,Trump
WASHINGTON,THURSTON,53067,65277,96608,161885,59.67693115483213,Biden
WASHINGTON,WAHKIAKUM,53069,1741,1165,2906,40.089470061940816,Trump
WASHINGTON,WALLA WALLA,53071,16400,13690,30090,45.49684280491858,Trump
WASHINGTON,WHATCOM,53073,50489,83660,134149,62.36349134171705,Biden
WASHINGTON,WHITMAN,53075,9067,11184,20251,55.226902375191344,Biden
WASHINGTON,YAKIMA,53077,50555,43179,93734,46.06546183882049,Trump
WEST VIRGINIA,BARBOUR,54001,5116,1457,6573,22.166438460368173,Trump
WEST VIRGINIA,BERKELEY,54003,33279,17186,50465,34.05528584167244,Trump
WEST VIRGINIA,BOONE,54005,6816,2041,8857,23.043920063226828,Trump
WEST VIRGINIA,BRAXTON,54007,4120,1457,5577,26.125156894387665,Trump
WEST VIRGINIA,BROOKE,54009,7545,2947,10492,28.0880670987419,Trump
WEST VIRGINIA,CABELL,54011,21721,14994,36715,40.838894184938034,Trump
WEST VIRGINIA,CALHOUN,54013,2364,568,2932,19.37244201909959,Trump
WEST VIRGINIA,CLAY,54015,2679,641,3320,19.307228915662648,Trump
WEST VIRGINIA,DODDRIDGE,54017,2619,435,3054,14.243614931237722,Trump
WEST VIRGINIA,FAYETTE,54019,11580,5063,16643,30.421198101303855,Trump
WEST VIRGINIA,GILMER,54021,2012,599,2611,22.941401761777097,Trump
WEST VIRGINIA,GRANT,54023,4871,607,5478,11.080686381891201,Trump
WEST VIRGINIA,GREENBRIER,54025,10925,4655,15580,29.878048780487802,Trump
WEST VIRGINIA,HAMPSHIRE,54027,8033,1939,9972,19.444444444444446,Trump
WEST VIRGINIA,HANCOCK,54029,9806,3790,13596,27.87584583701089,Trump
WEST VIRGINIA,HARDY,54031,4859,1381,6240,22.131410256410255,Trump
WEST VIRGINIA,HARRISON,54033,20683,9215,29898,30.82145962940665,Trump
WEST VIRGINIA,JACKSON,54035,10093,3207,13300,24.112781954887218,Trump
WEST VIRGINIA,JEFFERSON,54037,15033,12127,27160,44.65022091310751,Trump
WEST VIRGINIA,KANAWHA,54039,46398,34344,80742,42.53548339154343,Trump
WEST VIRGINIA,LEWIS,54041,5782,1538,7320,21.010928961748636,Trump
WEST VIRGINIA,LINCOLN,54043,6012,1711,7723,22.154603133497343,Trump
WEST VIRGINIA,LOGAN,54045,10534,2333,12867,18.131654620346623,Trump
WEST VIRGINIA,MARION,54049,16300,8901,25201,35.32002698305623,Trump
WEST VIRGINIA,MARSHALL,54051,10435,3455,13890,24.874010079193663,Trump
WEST VIRGINIA,MASON,54053,8491,2526,11017,22.928201869837526,Trump
WEST VIRGINIA,MCDOWELL,54047,5148,1333,6481,20.567813609010955,Trump
WEST VIRGINIA,MERCER,54055,19237,5556,24793,22.409551082966967,Trump
WEST VIRGINIA,MINERAL,54057,10040,2660,12700,20.94488188976378,Trump
WEST VIRGINIA,MINGO,54059,8544,1397,9941,14.052912181873051,Trump
WEST VIRGINIA,MONONGALIA,54061,20803,20282,41085,49.36594864305708,Trump
WEST VIRGINIA,MONROE,54063,5068,1345,6413,20.973023545922345,Trump
WEST VIRGINIA,MORGAN,54065,6537,1998,8535,23.409490333919155,Trump
WEST VIRGINIA,NICHOLAS,54067,8279,2226,10505,21.189909566872917,Trump
WEST VIRGINIA,OHIO,54069,12354,7223,19577,36.89533636410073,Trump
WEST VIRGINIA,PENDLETON,54071,2782,820,3602,22.76513048306496,Trump
WEST VIRGINIA,PLEASANTS,54073,2742,699,3441,20.31386224934612,Trump
WEST VIRGINIA,POCAHONTAS,54075,2895,1047,3942,26.56012176560122,Trump
WEST VIRGINIA,PRESTON,54077,11190,3163,14353,22.03720476555424,Trump
WEST VIRGINIA,PUTNAM,54079,20034,7878,27912,28.224419604471194,Trump
WEST VIRGINIA,RALEIGH,54081,24673,7982,32655,24.44342367171949,Trump
WEST VIRGINIA,RANDOLPH,54083,8673,3362,12035,27.935189031990028,Trump
WEST VIRGINIA,RITCHIE,54085,3649,586,4235,13.8370720188902,Trump
WEST VIRGINIA,ROANE,54087,4213,1455,5668,25.670430486944245,Trump
WEST VIRGINIA,SUMMERS,54089,4074,1448,5522,26.222383194494746,Trump
WEST VIRGINIA,TAYLOR,54091,5477,1796,7273,24.69407397222604,Trump
WEST VIRGINIA,TUCKER,54093,2841,938,3779,24.821381317808942,Trump
WEST VIRGINIA,TYLER,54095,3226,631,3857,16.35986518019186,Trump
WEST VIRGINIA,UPSHUR,54097,7771,2256,10027,22.49925201954722,Trump
WEST VIRGINIA,WAYNE,54099,12585,4088,16673,24.518682900497808,Trump
WEST VIRGINIA,WEBSTER,54101,2759,610,3369,18.106262986049273,Trump
WEST VIRGINIA,WETZEL,54103,4993,1539,6532,23.56093080220453,Trump
WEST VIRGINIA,WIRT,54105,2134,466,2600,17.923076923076923,Trump
WEST VIRGINIA,WOOD,54107,27202,10926,38128,28.65610574905581,Trump
WEST VIRGINIA,WYOMING,54109,7353,1157,8510,13.595769682726205,Trump
WISCONSIN,ADAMS,55001,7362,4329,11691,37.028483448806774,Trump
WISCONSIN,ASHLAND,55003,3841,4801,8642,55.554269844943306,Biden
WISCONSIN,BARRON,55005,15803,9194,24997,36.78041364963796,Trump
WISCONSIN,BAYFIELD,55007,4617,6147,10764,57.10702341137124,Biden
WISCONSIN,BROWN,55009,75871,65511,141382,46.33616726315938,Trump
WISCONSIN,BUFFALO,55011,4834,2860,7694,37.17182219911619,Trump
WISCONSIN,BURNETT,55013,6462,3569,10031,35.579702920945074,Trump
WISCONSIN,CALUMET,55015,18156,12116,30272,40.0237843551797,Trump
WISCONSIN,CHIPPEWA,55017,21317,13983,35300,39.611898016997166,Trump
WISCONSIN,CLARK,55019,10002,4524,14526,31.14415530772408,Trump
WISCONSIN,COLUMBIA,55021,16927,16410,33337,49.22458529561749,Trump
WISCONSIN,CRAWFORD,55023,4620,3953,8573,46.10987985535985,Trump
WISCONSIN,DANE,55025,78800,260185,338985,76.75413366373144,Biden
WISCONSIN,DODGE,55027,31355,16356,47711,34.281402611557084,Trump
WISCONSIN,DOOR,55029,9752,10044,19796,50.73752273186503,Biden
WISCONSIN,DOUGLAS,55031,10923,13218,24141,54.75332422020629,Biden
WISCONSIN,DUNN,55033,13173,9897,23070,42.8998699609883,Trump
WISCONSIN,EAU CLAIRE,55035,25341,31620,56961,55.51166587665245,Biden
WISCONSIN,FLORENCE,55037,2133,781,2914,26.801647220315715,Trump
WISCONSIN,FOND DU LAC,55039,35754,20588,56342,36.54112385076852,Trump
WISCONSIN,FOREST,55041,3285,1721,5006,34.378745505393525,Trump
WISCONSIN,GRANT,55043,14142,10998,25140,43.747016706443915,Trump
WISCONSIN,GREEN,55045,10169,10851,21020,51.62226450999049,Biden
WISCONSIN,GREEN LAKE,55047,7168,3344,10512,31.81126331811263,Trump
WISCONSIN,IOWA,55049,5909,7828,13737,56.984785615491006,Biden
WISCONSIN,IRON,55051,2438,1533,3971,38.60488541928985,Trump
WISCONSIN,JACKSON,55053,5791,4256,10047,42.36090375236389,Trump
WISCONSIN,JEFFERSON,55055,27208,19904,47112,42.248259466802516,Trump
WISCONSIN,JUNEAU,55057,8749,4746,13495,35.1685809559096,Trump
WISCONSIN,KENOSHA,55059,44972,42193,87165,48.4058968622727,Trump
WISCONSIN,KEWAUNEE,55061,7927,3976,11903,33.40334369486684,Trump
WISCONSIN,LA CROSSE,55063,28684,37846,66530,56.885615511799195,Biden
WISCONSIN,LAFAYETTE,55065,4821,3647,8468,43.068020784128485,Trump
WISCONSIN,LANGLADE,55067,7330,3704,11034,33.5689686423781,Trump
WISCONSIN,LINCOLN,55069,10017,6261,16278,38.46295613711758,Trump
WISCONSIN,MANITOWOC,55071,27218,16818,44036,38.19147969842856,Trump
WISCONSIN,MARATHON,55073,44624,30808,75432,40.84208293562414,Trump
WISCONSIN,MARINETTE,55075,15304,7366,22670,32.492280546978385,Trump
WISCONSIN,MARQUETTE,55077,5719,3239,8958,36.15762446974771,Trump
WISCONSIN,MENOMINEE,55078,278,1303,1581,82.41619228336496,Biden
WISCONSIN,MILWAUKEE,55079,134357,317270,451627,70.25045003952377,Biden
WISCONSIN,MONROE,55081,13775,8433,22208,37.97280259365994,Trump
WISCONSIN,OCONTO,55083,16226,6715,22941,29.270737980035744,Trump
WISCONSIN,ONEIDA,55085,13671,10105,23776,42.50084118438762,Trump
WISCONSIN,OUTAGAMIE,55087,58385,47667,106052,44.94681854184739,Trump
WISCONSIN,OZAUKEE,55089,33912,26517,60429,43.88124906915554,Trump
WISCONSIN,PEPIN,55091,2584,1489,4073,36.55781978885342,Trump
WISCONSIN,PIERCE,55093,12815,9796,22611,43.32404581840697,Trump
WISCONSIN,POLK,55095,16611,9370,25981,36.064816596743775,Trump
WISCONSIN,PORTAGE,55097,19299,20428,39727,51.42094796989453,Biden
WISCONSIN,PRICE,55099,5394,3032,8426,35.983859482553996,Trump
WISCONSIN,RACINE,55101,54479,50159,104638,47.93574036200997,Trump
WISCONSIN,RICHLAND,55103,4871,3995,8866,45.059778930746674,Trump
WISCONSIN,ROCK,55105,37138,46658,83796,55.68046207456203,Biden
WISCONSIN,RUSK,55107,5257,2517,7774,32.377154617957295,Trump
WISCONSIN,SAUK,55111,17493,18108,35601,50.86373978259038,Biden
WISCONSIN,SAWYER,55113,5909,4498,10407,43.2209090035553,Trump
WISCONSIN,SHAWANO,55115,15173,7131,22304,31.971843615494976,Trump
WISCONSIN,SHEBOYGAN,55117,37609,27101,64710,41.88069850100448,Trump
WISCONSIN,ST. CROIX,55109,32199,23190,55389,41.867518821426636,Trump
WISCONSIN,TAYLOR,55119,7657,2693,10350,26.019323671497585,Trump
WISCONSIN,TREMPEALEAU,55121,8833,6285,15118,41.57295938616219,Trump
WISCONSIN,VERNON,55123,8218,7457,15675,47.5725677830941,Trump
WISCONSIN,VILAS,55125,9261,5903,15164,38.92772355579003,Trump
WISCONSIN,WALWORTH,55127,33851,22789,56640,40.23481638418079,Trump
WISCONSIN,WASHBURN,55129,6334,3867,10201,37.90804823056563,Trump
WISCONSIN,WASHINGTON,55131,60237,26650,86887,30.67202228181431,Trump
WISCONSIN,WAUKESHA,55133,159649,103906,263555,39.424787994915675,Trump
WISCONSIN,WAUPACA,55135,18952,9703,28655,33.86145524341302,Trump
WISCONSIN,WAUSHARA,55137,9016,4388,13404,32.7364965681886,Trump
WISCONSIN,WINNEBAGO,55139,47796,44060,91856,47.966382163386164,Trump
WISCONSIN,WOOD,55141,24308,16365,40673,40.23553708848622,Trump
WYOMING,ALBANY,56001,8579,9092,17671,51.451530756606864,Biden
WYOMING,BIG HORN,56003,4806,788,5594,14.086521272792277,Trump
WYOMING,CAMPBELL,56005,16975,1935,18910,10.232681121099947,Trump
WYOMING,CARBON,56007,5014,1427,6441,22.154944884334732,Trump
WYOMING,CONVERSE,56009,5917,861,6778,12.702862201239304,Trump
WYOMING,CROOK,56011,3651,378,4029,9.381980640357408,Trump
WYOMING,FREMONT,56013,12007,5519,17526,31.490357183612915,Trump
WYOMING,GOSHEN,56015,4878,1203,6081,19.782930439072523,Trump
WYOMING,HOT SPRINGS,56017,1999,482,2481,19.427650141072146,Trump
WYOMING,JOHNSON,56019,3881,897,4778,18.773545416492258,Trump
WYOMING,LARAMIE,56021,27891,15217,43108,35.2997123503758,Trump
WYOMING,LINCOLN,56023,8643,1509,10152,14.864066193853429,Trump
WYOMING,NATRONA,56025,25271,8530,33801,25.235939765095704,Trump
WYOMING,NIOBRARA,56027,1118,155,1273,12.175962293794187,Trump
WYOMING,PARK,56029,12813,3410,16223,21.019540159033472,Trump
WYOMING,PLATTE,56031,3898,890,4788,18.58813700918964,Trump
WYOMING,SHERIDAN,56033,11843,4043,15886,25.450081833060555,Trump
WYOMING,SUBLETTE,56035,3957,882,4839,18.22690638561686,Trump
WYOMING,SWEETWATER,56037,12229,3823,16052,23.816346872663843,Trump
WYOMING,TETON,56039,4341,9848,14189,69.40587779265628,Biden
WYOMING,UINTA,56041,7496,1591,9087,17.50852866732695,Trump
WYOMING,WASHAKIE,56043,3245,651,3896,16.709445585215608,Trump
WYOMING,WESTON,56045,3107,360,3467,10.383616959907702,Trump
